pids,instantiation times,start times,finish times,average wait times,turnaround times,average queue lengths,response times,required cpu times,process sizes,turnaround times,efficiency,average response time,average queue length
1,801,823,870,2522.534832826748,69,2.0,22,45,TINY,2,0.949220504986971,1502.622,120
0,551,552,1251,2522.534832826748,700,1.5,1,405,LARGE,2,,,
2,865,871,2024,2522.534832826748,1159,2.2,6,492,LARGE,3,,,
4,1861,1876,2341,2522.534832826748,480,2.6,15,204,LARGE,3,,,
5,2186,2233,2628,2522.534832826748,442,2.4,47,186,SMALL,3,,,
3,1083,1090,2969,2522.534832826748,1886,1.8,7,988,LARGE,2,,,
6,2991,2992,3022,2522.534832826748,31,1.0,1,29,TINY,2,,,
10,3463,3518,3637,2522.534832826748,174,4.7,55,54,SMALL,4,,,
12,3656,3680,3717,2522.534832826748,61,5.0,24,36,TINY,2,,,
13,3779,3822,3839,2522.534832826748,60,5.0,43,17,TINY,4,,,
14,4066,4100,4146,2522.534832826748,80,5.0,34,44,TINY,2,,,
9,3426,3455,4373,2522.534832826748,947,4.2,29,167,SMALL,6,,,
7,3266,3267,4725,2522.534832826748,1459,2.9,1,398,LARGE,4,,,
15,4162,4199,4876,2522.534832826748,714,4.1,37,205,LARGE,4,,,
11,3540,3602,5997,2522.534832826748,2457,3.6,62,656,LARGE,4,,,
20,6178,6217,6269,2522.534832826748,91,6.0,39,50,TINY,2,,,
24,6910,6927,6962,2522.534832826748,52,9.0,17,34,TINY,2,,,
26,7181,7182,7228,2522.534832826748,47,10.0,1,44,TINY,2,,,
19,5969,5998,7247,2522.534832826748,1278,5.9,29,178,SMALL,8,,,
28,7552,7571,8210,2522.534832826748,658,10.4,19,104,SMALL,7,,,
16,5107,5137,8490,2522.534832826748,3383,5.8,30,508,LARGE,7,,,
8,3391,3434,9101,2522.534832826748,5710,5.0,43,937,LARGE,7,,,
29,7747,7790,9118,2522.534832826748,1371,11.0,43,126,SMALL,11,,,
23,6805,6812,9230,2522.534832826748,2425,9.4,7,217,LARGE,12,,,
35,9292,9346,9461,2522.534832826748,169,12.0,54,50,TINY,4,,,
25,6960,6963,9466,2522.534832826748,2506,9.8,3,214,LARGE,12,,,
39,9919,9968,10020,2522.534832826748,101,14.0,49,50,TINY,3,,,
45,10605,10987,11179,2522.534832826748,574,21.0,382,23,TINY,25,,,
47,11041,11180,11278,2522.534832826748,237,21.0,139,34,TINY,7,,,
34,9248,9304,11705,2522.534832826748,2457,15.7,56,138,SMALL,18,,,
32,8870,8907,11878,2522.534832826748,3008,14.8,37,175,SMALL,18,,,
36,9715,9727,12051,2522.534832826748,2336,16.3,12,125,SMALL,19,,,
44,10325,10693,12484,2522.534832826748,2159,21.0,368,65,SMALL,34,,,
21,6364,6374,12686,2522.534832826748,6322,12.3,10,453,LARGE,14,,,
57,12823,12854,12874,2522.534832826748,51,25.0,31,20,TINY,3,,,
58,12833,12875,12885,2522.534832826748,52,24.0,42,10,TINY,6,,,
51,11569,11624,13134,2522.534832826748,1565,23.5,55,78,SMALL,21,,,
61,13424,13447,13472,2522.534832826748,48,25.0,23,24,TINY,2,,,
62,13648,13681,13720,2522.534832826748,72,25.0,33,38,TINY,2,,,
41,10103,10399,13744,2522.534832826748,3641,21.5,296,133,SMALL,28,,,
43,10249,10588,13886,2522.534832826748,3637,21.9,339,146,SMALL,25,,,
64,14007,14054,14083,2522.534832826748,76,24.0,47,28,TINY,3,,,
30,8222,8263,15007,2522.534832826748,6785,17.5,41,355,LARGE,20,,,
70,15192,15216,15236,2522.534832826748,44,28.0,24,20,TINY,3,,,
72,15519,15560,15600,2522.534832826748,81,29.0,41,39,TINY,3,,,
73,15635,15653,15672,2522.534832826748,37,29.0,18,19,TINY,2,,,
74,15913,15933,15984,2522.534832826748,71,29.0,20,49,TINY,2,,,
75,16088,16089,16132,2522.534832826748,44,29.0,1,41,TINY,2,,,
76,16180,16185,16205,2522.534832826748,25,30.0,5,20,TINY,2,,,
78,16199,16227,16314,2522.534832826748,115,30.3,28,43,TINY,3,,,
84,17392,17420,17514,2522.534832826748,122,35.0,28,50,TINY,3,,,
87,17887,17901,17935,2522.534832826748,48,37.0,14,33,TINY,2,,,
90,18257,18301,18374,2522.534832826748,117,39.0,44,50,TINY,3,,,
92,18442,18469,18582,2522.534832826748,140,41.0,27,48,TINY,3,,,
96,18869,18886,18920,2522.534832826748,51,43.0,17,33,TINY,2,,,
80,16368,16378,18954,2522.534832826748,2586,35.4,10,92,SMALL,29,,,
66,14250,14251,20334,2522.534832826748,6084,31.5,1,161,SMALL,38,,,
93,18448,18511,20460,2522.534832826748,2012,42.5,63,80,SMALL,26,,,
89,18179,18217,21398,2522.534832826748,3219,43.4,38,93,SMALL,35,,,
94,18750,18760,21523,2522.534832826748,2773,45.0,10,99,SMALL,29,,,
18,5740,5762,21709,2522.534832826748,15969,18.3,22,757,LARGE,22,,,
40,10097,10378,22021,2522.534832826748,11924,30.1,281,317,LARGE,38,,,
113,21815,22883,22899,2522.534832826748,1084,56.0,1068,16,TINY,68,,,
108,21218,22232,23117,2522.534832826748,1899,53.5,1014,27,TINY,71,,,
112,21514,22568,23254,2522.534832826748,1740,54.5,1054,30,TINY,58,,,
121,23672,23738,23753,2522.534832826748,81,57.0,66,15,TINY,6,,,
122,23818,23848,23865,2522.534832826748,47,57.0,30,17,TINY,3,,,
85,17539,17567,24228,2522.534832826748,6689,44.9,28,148,SMALL,46,,,
46,10728,11071,24413,2522.534832826748,13685,32.5,343,348,LARGE,40,,,
65,14076,14084,24491,2522.534832826748,10415,37.0,8,245,LARGE,43,,,
49,11453,11498,25003,2522.534832826748,13550,34.1,45,330,LARGE,42,,,
37,9738,9769,26050,2522.534832826748,16312,30.3,31,444,LARGE,37,,,
81,17042,17065,26153,2522.534832826748,9111,46.2,23,219,LARGE,42,,,
133,26307,26321,26365,2522.534832826748,58,61.0,14,42,TINY,2,,,
136,26680,26700,26732,2522.534832826748,52,63.0,20,31,TINY,2,,,
105,20715,21710,26740,2522.534832826748,6025,56.0,995,67,SMALL,90,,,
114,22423,23181,27150,2522.534832826748,4727,56.5,758,83,SMALL,57,,,
141,27859,27901,27950,2522.534832826748,91,65.0,42,47,TINY,2,,,
143,28010,28045,28063,2522.534832826748,53,67.0,35,18,TINY,3,,,
91,18393,18427,28848,2522.534832826748,10455,50.9,34,183,SMALL,58,,,
147,29098,29130,29174,2522.534832826748,76,68.0,32,22,TINY,4,,,
60,13042,13053,29502,2522.534832826748,16460,42.7,11,365,LARGE,46,,,
53,11894,11931,29926,2522.534832826748,18032,40.7,37,417,LARGE,44,,,
31,8313,8326,30013,2522.534832826748,21700,29.9,13,603,LARGE,36,,,
42,10134,10462,30803,2522.534832826748,20669,39.6,328,422,LARGE,49,,,
17,5679,5720,30892,2522.534832826748,25213,24.1,41,884,LARGE,29,,,
52,11729,11758,31280,2522.534832826748,19551,42.3,29,429,LARGE,46,,,
22,6664,6697,31525,2522.534832826748,24861,27.6,33,763,LARGE,33,,,
102,20085,21049,31582,2522.534832826748,11497,60.7,964,144,SMALL,80,,,
116,22621,23255,31871,2522.534832826748,9250,62.9,634,145,SMALL,64,,,
33,9242,9283,32505,2522.534832826748,23263,36.5,41,553,LARGE,43,,,
150,30021,31386,32983,2522.534832826748,2962,78.0,1365,35,TINY,85,,,
152,30073,31449,33033,2522.534832826748,2960,78.0,1376,27,TINY,110,,,
103,20217,21196,33174,2522.534832826748,12957,63.2,979,164,SMALL,80,,,
120,23582,23696,33521,2522.534832826748,9939,65.1,114,160,SMALL,63,,,
124,24023,24033,33681,2522.534832826748,9658,66.2,10,162,SMALL,60,,,
157,30779,32229,33795,2522.534832826748,3016,77.5,1450,28,TINY,108,,,
159,30908,32397,33971,2522.534832826748,3063,78.0,1489,27,TINY,114,,,
59,12895,12938,34152,2522.534832826748,21257,47.4,43,422,LARGE,51,,,
163,31155,32716,34937,2522.534832826748,3782,78.0,1561,47,TINY,81,,,
171,33206,34636,35046,2522.534832826748,1840,78.0,1430,23,TINY,80,,,
178,35059,35299,35310,2522.534832826748,251,79.0,240,11,TINY,23,,,
179,35273,35416,35484,2522.534832826748,211,79.0,143,25,TINY,9,,,
182,35930,35964,35984,2522.534832826748,54,80.0,34,20,TINY,3,,,
107,20849,21878,36153,2522.534832826748,15304,66.1,1029,192,SMALL,80,,,
184,36271,36321,36374,2522.534832826748,103,80.0,50,51,SMALL,3,,,
187,36474,36532,36543,2522.534832826748,69,82.0,58,11,TINY,7,,,
118,23199,23423,36686,2522.534832826748,13487,66.7,224,187,SMALL,73,,,
142,27996,28003,37497,2522.534832826748,9501,72.9,7,147,SMALL,65,,,
144,28028,28085,37549,2522.534832826748,9521,74.2,57,170,SMALL,57,,,
145,28144,28148,37597,2522.534832826748,9453,74.4,4,166,SMALL,57,,,
193,37698,37702,37730,2522.534832826748,32,83.0,4,27,TINY,2,,,
194,37794,37835,37870,2522.534832826748,76,83.0,41,34,TINY,3,,,
88,18169,18196,38068,2522.534832826748,19899,60.7,27,320,LARGE,63,,,
196,38123,38163,38227,2522.534832826748,104,84.0,40,21,TINY,5,,,
198,38296,38322,38353,2522.534832826748,57,84.0,26,30,TINY,2,,,
97,18976,19007,38731,2522.534832826748,19755,62.1,31,322,LARGE,62,,,
202,39443,39471,39495,2522.534832826748,52,86.0,28,23,TINY,3,,,
156,30523,31956,39681,2522.534832826748,9158,80.0,1433,78,SMALL,118,,,
160,30935,32460,39841,2522.534832826748,8906,81.4,1525,103,SMALL,87,,,
188,36784,36791,40755,2522.534832826748,3971,83.2,7,61,SMALL,66,,,
48,11102,11243,41064,2522.534832826748,29962,48.4,141,544,LARGE,56,,,
158,30798,32271,41731,2522.534832826748,10933,82.7,1473,125,SMALL,88,,,
139,27501,27515,42596,2522.534832826748,15095,76.1,14,193,SMALL,79,,,
211,41583,43437,43454,2522.534832826748,1871,97.0,1854,17,TINY,111,,,
215,42391,44295,44314,2522.534832826748,1923,101.0,1904,19,TINY,102,,,
197,38143,38205,44944,2522.534832826748,6801,88.8,62,120,SMALL,57,,,
199,38467,38510,45095,2522.534832826748,6628,89.5,43,103,SMALL,65,,,
50,11487,11519,45221,2522.534832826748,33734,54.1,32,590,LARGE,58,,,
227,44730,45873,45887,2522.534832826748,1157,100.0,1143,14,TINY,83,,,
216,42926,44840,45929,2522.534832826748,3003,100.5,1914,40,TINY,76,,,
218,43018,44987,45976,2522.534832826748,2958,100.0,1969,24,TINY,124,,,
221,43442,45432,46027,2522.534832826748,2585,98.5,1990,28,TINY,93,,,
223,43686,45684,46329,2522.534832826748,2643,97.7,1998,47,TINY,57,,,
226,44533,45831,46381,2522.534832826748,1848,97.3,1298,49,TINY,38,,,
230,46388,46445,46465,2522.534832826748,77,97.0,57,20,TINY,4,,,
234,46766,46780,46832,2522.534832826748,66,99.0,14,50,TINY,2,,,
167,31787,33364,46994,2522.534832826748,15207,88.6,1577,165,SMALL,93,,,
173,33856,34783,47429,2522.534832826748,13573,89.0,927,156,SMALL,88,,,
242,48114,48139,48178,2522.534832826748,64,104.5,25,38,TINY,2,,,
181,35903,35943,48500,2522.534832826748,12597,90.8,40,158,SMALL,80,,,
110,21359,22400,48788,2522.534832826748,27429,75.6,1041,296,LARGE,93,,,
246,49085,49101,49115,2522.534832826748,30,105.0,16,14,TINY,3,,,
249,49604,49606,49628,2522.534832826748,24,107.0,2,21,TINY,2,,,
54,12271,12312,49829,2522.534832826748,37558,58.6,41,583,LARGE,65,,,
250,49977,49986,50003,2522.534832826748,26,106.0,9,17,TINY,2,,,
214,42303,44190,50846,2522.534832826748,8543,100.8,1887,73,SMALL,118,,,
27,7491,7508,52544,2522.534832826748,45053,44.9,17,887,LARGE,51,,,
213,42301,44169,53017,2522.534832826748,10716,104.2,1868,90,SMALL,120,,,
172,33695,34741,53527,2522.534832826748,19832,94.0,1046,195,SMALL,102,,,
255,51465,53696,53711,2522.534832826748,2246,121.0,2231,15,TINY,150,,,
82,17132,17180,53795,2522.534832826748,36663,70.7,48,480,LARGE,77,,,
138,26817,26856,53957,2522.534832826748,27140,86.1,39,314,LARGE,87,,,
256,51719,53958,53969,2522.534832826748,2250,119.0,2239,11,TINY,205,,,
190,37074,37125,54330,2522.534832826748,17256,97.0,51,193,SMALL,90,,,
262,52286,54625,54645,2522.534832826748,2359,119.0,2339,20,TINY,118,,,
146,29086,29109,54756,2522.534832826748,25670,87.4,23,275,LARGE,94,,,
238,47255,47277,55926,2522.534832826748,8671,109.2,22,114,SMALL,77,,,
247,49178,49220,56670,2522.534832826748,7492,111.7,42,108,SMALL,70,,,
86,17584,17609,56935,2522.534832826748,39351,76.0,25,492,LARGE,80,,,
280,55309,57209,57220,2522.534832826748,1911,129.0,1900,11,TINY,174,,,
254,51280,53501,57355,2522.534832826748,6075,124.0,2221,48,TINY,127,,,
270,53607,56053,57385,2522.534832826748,3778,125.5,2446,28,TINY,135,,,
275,54978,57062,57718,2522.534832826748,2740,126.5,2084,37,TINY,75,,,
269,53583,56011,57979,2522.534832826748,4396,125.3,2428,48,TINY,92,,,
285,56910,57596,58100,2522.534832826748,1190,125.0,686,35,TINY,34,,,
281,55476,57242,58293,2522.534832826748,2817,125.7,1766,43,TINY,66,,,
291,58492,58546,58593,2522.534832826748,101,125.0,54,45,TINY,3,,,
125,24502,24544,58621,2522.534832826748,34119,81.9,42,357,LARGE,96,,,
294,59163,59164,59200,2522.534832826748,37,126.0,1,35,TINY,2,,,
200,38606,38625,59207,2522.534832826748,20601,100.2,19,186,SMALL,111,,,
149,29926,29927,59690,2522.534832826748,29764,90.4,1,304,LARGE,98,,,
154,30145,31547,59824,2522.534832826748,29679,96.2,1402,259,LARGE,115,,,
134,26459,26470,60869,2522.534832826748,34410,89.7,11,357,LARGE,97,,,
283,56836,57533,61934,2522.534832826748,5098,125.8,697,74,SMALL,69,,,
210,41190,43017,62711,2522.534832826748,21521,112.2,1827,160,SMALL,135,,,
237,47087,47110,63140,2522.534832826748,16053,113.9,23,148,SMALL,109,,,
240,47771,47805,63349,2522.534832826748,15578,115.4,34,159,SMALL,98,,,
185,36414,36427,63672,2522.534832826748,27258,103.9,13,257,LARGE,107,,,
248,49511,49543,63892,2522.534832826748,14381,117.1,32,149,SMALL,97,,,
282,56099,57386,64573,2522.534832826748,8474,128.6,1287,88,SMALL,97,,,
314,63202,66023,66043,2522.534832826748,2841,145.0,2821,20,TINY,143,,,
297,60855,63413,66264,2522.534832826748,5409,142.5,2558,30,TINY,181,,,
261,52122,54436,67067,2522.534832826748,14945,131.5,2314,104,SMALL,144,,,
264,52680,55030,67096,2522.534832826748,14416,131.8,2350,107,SMALL,135,,,
306,62356,65057,67964,2522.534832826748,5608,148.5,2701,26,TINY,216,,,
309,62806,65540,68235,2522.534832826748,5429,149.0,2734,38,TINY,143,,,
295,60482,63027,68314,2522.534832826748,7832,144.7,2545,55,SMALL,143,,,
318,63995,66853,68715,2522.534832826748,4720,154.5,2858,21,TINY,225,,,
319,64380,67244,68808,2522.534832826748,4428,153.5,2864,28,TINY,159,,,
307,62388,65099,69047,2522.534832826748,6659,151.0,2711,47,TINY,142,,,
324,65719,68257,69125,2522.534832826748,3406,156.0,2538,34,TINY,101,,,
337,67519,68872,69599,2522.534832826748,2080,157.0,1353,31,TINY,68,,,
321,64881,67769,69671,2522.534832826748,4790,156.7,2888,48,TINY,100,,,
345,68957,69672,69683,2522.534832826748,726,159.0,715,11,TINY,66,,,
340,67902,68998,69692,2522.534832826748,1790,157.0,1096,28,TINY,64,,,
346,69053,69735,70288,2522.534832826748,1235,159.5,682,27,TINY,46,,,
349,69300,69903,70388,2522.534832826748,1088,160.5,603,35,TINY,32,,,
224,44052,45726,70700,2522.534832826748,26648,119.9,1674,197,SMALL,136,,,
189,36795,36833,71536,2522.534832826748,34741,111.0,38,306,LARGE,114,,,
252,51233,53417,71755,2522.534832826748,20522,135.9,2184,128,SMALL,161,,,
265,52924,55303,71885,2522.534832826748,18961,136.6,2379,123,SMALL,155,,,
98,19391,19434,72608,2522.534832826748,53217,89.3,43,568,LARGE,94,,,
326,66026,68420,73187,2522.534832826748,7161,159.5,2394,71,SMALL,101,,,
235,46866,46885,73978,2522.534832826748,27112,125.6,19,213,LARGE,128,,,
176,34428,34959,74143,2522.534832826748,39715,112.6,531,327,LARGE,122,,,
109,21348,22379,74398,2522.534832826748,53050,98.1,1031,472,LARGE,113,,,
111,21414,22463,74466,2522.534832826748,53052,98.4,1049,474,LARGE,112,,,
251,50452,52629,74789,2522.534832826748,24337,138.8,2177,147,SMALL,166,,,
259,52085,54352,74899,2522.534832826748,22814,139.9,2267,144,SMALL,159,,,
274,54825,56999,75108,2522.534832826748,20283,141.1,2174,159,SMALL,128,,,
367,72636,75781,75799,2522.534832826748,3163,174.0,3145,18,TINY,176,,,
316,63491,66328,76277,2522.534832826748,12786,160.8,2837,95,SMALL,135,,,
323,65631,68236,76346,2522.534832826748,10715,162.8,2605,85,SMALL,127,,,
355,70049,73272,76485,2522.534832826748,6436,172.0,3223,32,TINY,202,,,
208,41004,42807,76798,2522.534832826748,35794,128.4,1803,238,LARGE,151,,,
38,9740,9790,77405,2522.534832826748,67665,69.9,50,878,LARGE,78,,,
377,74395,77595,77614,2522.534832826748,3219,176.0,3200,19,TINY,170,,,
290,58332,58441,78609,2522.534832826748,20277,145.3,109,167,SMALL,122,,,
56,12699,12739,78672,2522.534832826748,65973,81.2,40,770,LARGE,86,,,
298,60875,63455,79288,2522.534832826748,18413,160.3,2580,106,SMALL,174,,,
303,61890,64544,79386,2522.534832826748,17496,161.7,2654,113,SMALL,155,,,
329,66308,68525,79783,2522.534832826748,13475,166.2,2217,118,SMALL,115,,,
358,70316,73461,79879,2522.534832826748,9563,175.0,3145,51,SMALL,188,,,
379,75083,78308,80227,2522.534832826748,5144,179.0,3225,31,TINY,166,,,
381,75327,78581,80332,2522.534832826748,5005,179.5,3254,40,TINY,126,,,
372,73616,76759,80802,2522.534832826748,7186,179.0,3143,47,TINY,153,,,
166,31728,33280,81708,2522.534832826748,49980,119.3,1552,352,LARGE,142,,,
135,26557,26585,82006,2522.534832826748,55449,109.2,28,463,LARGE,120,,,
71,15291,15341,82248,2522.534832826748,66957,90.0,50,680,LARGE,99,,,
77,16184,16206,82902,2522.534832826748,66718,92.7,22,672,LARGE,100,,,
293,59014,59049,82959,2522.534832826748,23945,150.3,35,194,SMALL,124,,,
69,14800,14866,83144,2522.534832826748,68344,89.9,66,736,LARGE,93,,,
395,78379,80249,83844,2522.534832826748,5465,184.0,1870,26,TINY,211,,,
403,79563,80690,84190,2522.534832826748,4627,184.0,1127,29,TINY,160,,,
55,12503,12537,85902,2522.534832826748,73399,86.4,34,800,LARGE,92,,,
276,54992,57083,86139,2522.534832826748,31147,153.5,2091,205,LARGE,152,,,
279,55152,57167,86217,2522.534832826748,31065,154.1,2015,214,LARGE,146,,,
195,38096,38121,86392,2522.534832826748,48296,128.6,25,376,LARGE,129,,,
301,61684,64292,86832,2522.534832826748,25148,169.4,2608,159,SMALL,159,,,
407,80807,84233,87593,2522.534832826748,6786,195.5,3426,24,TINY,283,,,
350,69514,70092,87992,2522.534832826748,18478,180.2,578,120,SMALL,154,,,
410,81503,84947,88293,2522.534832826748,6790,197.5,3444,26,TINY,262,,,
233,46595,46613,88497,2522.534832826748,41902,141.9,18,294,LARGE,143,,,
67,14573,14574,90127,2522.534832826748,75554,95.8,1,772,LARGE,98,,,
68,14793,14845,90227,2522.534832826748,75434,96.3,52,775,LARGE,98,,,
426,85140,88498,91222,2522.534832826748,6082,211.5,3358,27,TINY,226,,,
434,85924,89443,91595,2522.534832826748,5671,215.0,3519,35,TINY,163,,,
437,86238,89779,91715,2522.534832826748,5477,216.0,3541,34,TINY,162,,,
365,72189,75298,91886,2522.534832826748,19697,187.0,3109,62,SMALL,318,,,
375,74184,77345,92040,2522.534832826748,17856,189.0,3161,66,SMALL,271,,,
380,75161,78392,92103,2522.534832826748,16942,190.5,3231,80,SMALL,212,,,
399,79010,80480,92459,2522.534832826748,13449,197.5,1470,79,SMALL,171,,,
343,68575,69399,92769,2522.534832826748,24194,181.7,824,135,SMALL,180,,,
104,20288,21280,93592,2522.534832826748,73304,115.4,992,573,LARGE,128,,,
258,51977,54243,93976,2522.534832826748,41999,162.6,2266,245,LARGE,172,,,
266,53019,55408,94035,2522.534832826748,41016,163.1,2389,256,LARGE,161,,,
458,90115,94414,94430,2522.534832826748,4315,220.0,4299,16,TINY,270,,,
459,90172,94452,94467,2522.534832826748,4295,219.0,4280,15,TINY,287,,,
439,86609,90191,94474,2522.534832826748,7865,216.5,3582,26,TINY,303,,,
442,87479,90900,94669,2522.534832826748,7190,218.5,3421,25,TINY,288,,,
445,87984,91110,94836,2522.534832826748,6852,218.0,3126,39,TINY,176,,,
447,88540,91244,94941,2522.534832826748,6401,217.5,2704,40,TINY,161,,,
451,89214,91454,95099,2522.534832826748,5885,218.0,2240,30,TINY,197,,,
436,86202,89737,95299,2522.534832826748,9097,216.3,3535,50,TINY,182,,,
361,71757,74811,95377,2522.534832826748,23620,192.6,3054,94,SMALL,252,,,
333,66668,68651,96245,2522.534832826748,29577,186.0,1983,146,SMALL,203,,,
170,33129,34615,97043,2522.534832826748,63914,136.3,1486,450,LARGE,143,,,
174,33995,34825,97048,2522.534832826748,63053,136.3,830,434,LARGE,146,,,
438,86577,90128,98044,2522.534832826748,11467,219.7,3551,48,TINY,239,,,
460,90291,94475,98051,2522.534832826748,7760,221.0,4184,26,TINY,299,,,
440,86978,90543,98106,2522.534832826748,11128,219.3,3565,52,SMALL,214,,,
471,92129,95756,99023,2522.534832826748,6894,221.5,3627,33,TINY,209,,,
385,75854,79156,99086,2522.534832826748,23232,201.8,3302,120,SMALL,194,,,
394,77943,80111,99395,2522.534832826748,21452,206.2,2168,114,SMALL,189,,,
401,79228,80585,99488,2522.534832826748,20260,206.0,1357,108,SMALL,188,,,
474,92935,96561,99902,2522.534832826748,6967,222.5,3626,34,TINY,205,,,
99,19693,19705,100465,2522.534832826748,80772,115.6,12,676,LARGE,120,,,
489,97209,100529,100546,2522.534832826748,3337,222.0,3320,17,TINY,197,,,
272,54069,56494,101141,2522.534832826748,47072,170.9,2425,286,LARGE,165,,,
289,58089,58357,101303,2522.534832826748,43214,171.4,268,294,LARGE,147,,,
126,24655,24659,101318,2522.534832826748,76663,125.4,4,624,LARGE,123,,,
79,16271,16315,101417,2522.534832826748,85146,109.3,44,784,LARGE,109,,,
464,90780,94601,101507,2522.534832826748,10727,219.0,3821,45,TINY,239,,,
484,95834,99108,101872,2522.534832826748,6038,220.0,3274,27,TINY,224,,,
412,81534,85010,102778,2522.534832826748,21244,207.0,3476,62,SMALL,343,,,
366,72293,75424,103605,2522.534832826748,31312,200.7,3131,127,SMALL,247,,,
387,76087,79408,103861,2522.534832826748,27774,203.6,3321,123,SMALL,226,,,
342,68546,69357,104283,2522.534832826748,35737,192.8,811,181,SMALL,198,,,
475,93074,96729,104588,2522.534832826748,11514,218.7,3655,50,TINY,231,,,
476,93722,97385,104633,2522.534832826748,10911,218.0,3663,42,TINY,260,,,
495,98586,101634,104793,2522.534832826748,6207,212.5,3048,32,TINY,194,,,
496,98619,101676,104833,2522.534832826748,6214,212.0,3057,38,TINY,164,,,
487,95974,99318,104941,2522.534832826748,8967,215.3,3344,42,TINY,214,,,
498,99406,101957,104959,2522.534832826748,5553,210.5,2551,37,TINY,151,,,
328,66195,68483,105577,2522.534832826748,39382,183.6,2288,208,LARGE,190,,,
432,85750,89233,106126,2522.534832826748,20376,212.2,3483,82,SMALL,249,,,
452,89250,91496,106318,2522.534832826748,17068,215.0,2246,82,SMALL,209,,,
499,99793,101978,107636,2522.534832826748,7843,207.3,2185,55,SMALL,143,,,
357,70138,73335,108275,2522.534832826748,38137,194.6,3197,168,SMALL,228,,,
416,82932,86435,108464,2522.534832826748,25532,208.2,3503,120,SMALL,213,,,
422,84217,87568,108585,2522.534832826748,24368,209.3,3351,115,SMALL,212,,,
455,89511,91617,108990,2522.534832826748,19479,211.8,2106,105,SMALL,186,,,
369,72695,75884,109160,2522.534832826748,36465,200.8,3189,161,SMALL,227,,,
397,78674,80375,109534,2522.534832826748,30860,205.0,1701,176,SMALL,176,,,
402,79401,80627,109582,2522.534832826748,30181,205.0,1226,165,SMALL,183,,,
404,79708,80732,109603,2522.534832826748,29895,204.9,1024,180,SMALL,167,,,
228,45868,46196,110176,2522.534832826748,64308,156.8,328,365,LARGE,177,,,
236,46955,46995,110302,2522.534832826748,63347,157.8,40,380,LARGE,167,,,
287,57143,57782,111118,2522.534832826748,53975,172.4,639,317,LARGE,171,,,
466,91660,95268,111297,2522.534832826748,19637,211.2,3608,70,SMALL,281,,,
312,63047,65834,112187,2522.534832826748,49140,184.0,2787,247,LARGE,199,,,
313,63179,65981,112204,2522.534832826748,49025,184.2,2802,256,LARGE,192,,,
320,64837,67706,112252,2522.534832826748,47415,185.2,2869,245,LARGE,194,,,
417,83016,86519,112527,2522.534832826748,29511,205.1,3503,121,SMALL,244,,,
431,85529,88981,112770,2522.534832826748,27241,206.1,3452,131,SMALL,208,,,
373,73666,76820,113220,2522.534832826748,39554,198.9,3154,188,SMALL,211,,,
376,74281,77469,113255,2522.534832826748,38974,199.4,3188,193,SMALL,202,,,
117,22690,23276,114520,2522.534832826748,91830,127.1,586,654,LARGE,141,,,
100,19932,19976,114546,2522.534832826748,94614,122.3,44,704,LARGE,135,,,
465,91181,94858,115094,2522.534832826748,23913,205.0,3677,81,SMALL,296,,,
470,92124,95714,115171,2522.534832826748,23047,205.4,3590,93,SMALL,248,,,
472,92171,95819,115178,2522.534832826748,23007,205.0,3648,86,SMALL,268,,,
490,97240,100589,115426,2522.534832826748,18186,199.8,3349,96,SMALL,190,,,
201,38832,38836,115598,2522.534832826748,76766,146.2,4,493,LARGE,156,,,
433,85787,89296,116488,2522.534832826748,30701,202.4,3509,147,SMALL,209,,,
443,87925,91047,116545,2522.534832826748,28620,204.0,3122,154,SMALL,186,,,
162,31133,32674,117573,2522.534832826748,86440,147.9,1541,569,LARGE,152,,,
137,26788,26793,118093,2522.534832826748,91305,133.2,5,635,LARGE,144,,,
477,94660,98170,118842,2522.534832826748,24182,197.5,3510,113,SMALL,214,,,
488,96717,100050,119025,2522.534832826748,22308,195.3,3333,114,SMALL,196,,,
153,30131,31526,119260,2522.534832826748,89129,142.2,1395,563,LARGE,159,,,
308,62617,65351,119465,2522.534832826748,56848,182.1,2734,295,LARGE,193,,,
423,84413,87720,119911,2522.534832826748,35498,197.9,3307,164,SMALL,217,,,
450,89133,91433,120176,2522.534832826748,31043,199.7,2300,172,SMALL,181,,,
161,31130,32653,121064,2522.534832826748,89934,148.3,1523,565,LARGE,160,,,
219,43326,45285,121205,2522.534832826748,77879,159.0,1959,434,LARGE,180,,,
239,47511,47534,121457,2522.534832826748,73946,160.2,23,440,LARGE,169,,,
119,23415,23549,121696,2522.534832826748,98281,129.5,134,697,LARGE,142,,,
63,13864,13887,121832,2522.534832826748,107968,109.9,23,909,LARGE,119,,,
204,39671,39682,122776,2522.534832826748,83105,148.2,11,549,LARGE,152,,,
305,62281,64952,122896,2522.534832826748,60615,180.5,2671,314,LARGE,194,,,
311,63043,65813,122925,2522.534832826748,59882,180.8,2770,307,LARGE,196,,,
325,65792,68315,122994,2522.534832826748,57202,181.5,2523,305,LARGE,188,,,
244,48206,48242,123843,2522.534832826748,75637,160.8,36,448,LARGE,169,,,
140,27655,27682,123980,2522.534832826748,96325,135.4,27,670,LARGE,144,,,
123,23939,23970,123982,2522.534832826748,100043,130.7,31,711,LARGE,141,,,
479,95033,98338,124551,2522.534832826748,29518,187.1,3305,141,SMALL,210,,,
296,60528,63090,124958,2522.534832826748,64430,177.9,2562,327,LARGE,198,,,
217,43007,44945,125618,2522.534832826748,82611,158.6,1938,468,LARGE,177,,,
231,46439,46487,125720,2522.534832826748,79281,158.6,48,477,LARGE,167,,,
253,51248,53459,126145,2522.534832826748,74897,169.6,2211,404,LARGE,186,,,
277,55044,57125,126311,2522.534832826748,71267,170.0,2081,418,LARGE,171,,,
478,94929,98275,126626,2522.534832826748,31697,182.7,3346,180,SMALL,177,,,
481,95347,98590,126656,2522.534832826748,31309,182.4,3243,168,SMALL,187,,,
95,18770,18802,126859,2522.534832826748,108089,120.8,32,853,LARGE,127,,,
449,88834,91370,127939,2522.534832826748,39105,189.5,2536,211,LARGE,186,,,
454,89384,91559,128010,2522.534832826748,38626,193.7,2175,198,SMALL,196,,,
222,43648,45663,130202,2522.534832826748,86554,157.8,2015,496,LARGE,175,,,
183,36205,36206,130515,2522.534832826748,94310,146.7,1,608,LARGE,156,,,
101,19954,19997,130595,2522.534832826748,110641,126.6,43,816,LARGE,136,,,
83,17390,17399,130606,2522.534832826748,113216,120.6,9,870,LARGE,131,,,
468,92101,95651,131033,2522.534832826748,38932,179.6,3550,186,SMALL,210,,,
368,72675,75842,132320,2522.534832826748,59645,183.3,3167,295,LARGE,203,,,
131,25688,25713,134197,2522.534832826748,108509,132.1,25,777,LARGE,140,,,
330,66355,68567,134462,2522.534832826748,68107,173.7,2212,392,LARGE,174,,,
332,66564,68609,135517,2522.534832826748,68953,178.5,2045,374,LARGE,185,,,
339,67758,68935,135617,2522.534832826748,67859,178.6,1177,385,LARGE,177,,,
148,29521,29555,136982,2522.534832826748,107461,136.0,34,760,LARGE,142,,,
386,75916,79240,138069,2522.534832826748,62153,178.2,3324,345,LARGE,181,,,
206,40387,42173,138663,2522.534832826748,98276,158.6,1786,557,LARGE,177,,,
220,43384,45369,138867,2522.534832826748,95483,154.2,1985,586,LARGE,163,,,
165,31576,33118,139093,2522.534832826748,107517,144.2,1542,667,LARGE,162,,,
132,26190,26206,139367,2522.534832826748,113177,134.4,16,773,LARGE,147,,,
106,20753,21752,139497,2522.534832826748,118744,130.7,999,835,LARGE,143,,,
191,37281,37292,139660,2522.534832826748,102379,146.1,11,656,LARGE,157,,,
192,37301,37334,139682,2522.534832826748,102381,146.1,33,671,LARGE,153,,,
263,52549,54883,139810,2522.534832826748,87261,163.7,2334,503,LARGE,174,,,
130,25371,25390,140538,2522.534832826748,115167,131.6,19,825,LARGE,140,,,
415,82640,86140,140967,2522.534832826748,58327,171.9,3500,308,LARGE,190,,,
127,24787,24826,142650,2522.534832826748,117863,132.1,39,832,LARGE,142,,,
486,95918,99234,142913,2522.534832826748,46995,163.2,3316,270,LARGE,175,,,
371,73214,76410,143971,2522.534832826748,70757,171.3,3196,377,LARGE,188,,,
225,44072,45747,144639,2522.534832826748,100567,151.9,1675,626,LARGE,161,,,
175,34088,34867,144749,2522.534832826748,110661,142.7,779,724,LARGE,153,,,
243,48139,48179,144818,2522.534832826748,96679,152.9,40,615,LARGE,158,,,
462,90473,94517,145170,2522.534832826748,54697,161.3,4044,295,LARGE,186,,,
492,97612,100988,145376,2522.534832826748,47764,158.7,3376,296,LARGE,162,,,
302,61829,64460,145573,2522.534832826748,83744,163.8,2631,467,LARGE,180,,,
317,63746,66601,145646,2522.534832826748,81900,164.5,2855,469,LARGE,175,,,
424,84557,87888,145959,2522.534832826748,61402,165.6,3331,358,LARGE,172,,,
398,78994,80459,146623,2522.534832826748,67629,169.8,1465,402,LARGE,169,,,
354,69805,70331,146902,2522.534832826748,77097,169.0,526,455,LARGE,170,,,
177,34674,35047,147110,2522.534832826748,112436,141.8,373,758,LARGE,149,,,
186,36423,36448,147189,2522.534832826748,110766,142.4,25,755,LARGE,147,,,
128,25049,25056,147630,2522.534832826748,122581,130.6,7,902,LARGE,136,,,
428,85223,88624,149611,2522.534832826748,64388,162.4,3401,364,LARGE,177,,,
429,85303,88708,149661,2522.534832826748,64358,159.3,3405,408,LARGE,158,,,
335,66836,68693,150511,2522.534832826748,83675,165.4,1857,472,LARGE,178,,,
168,32343,33901,150859,2522.534832826748,118516,140.5,1558,771,LARGE,154,,,
241,47957,47972,150917,2522.534832826748,102960,149.8,15,665,LARGE,155,,,
115,22450,23202,150942,2522.534832826748,128492,128.9,752,923,LARGE,140,,,
271,53868,56305,151047,2522.534832826748,97179,155.1,2437,610,LARGE,160,,,
203,39578,39600,151515,2522.534832826748,111937,140.9,22,765,LARGE,147,,,
310,63004,65750,151597,2522.534832826748,88593,157.2,2746,548,LARGE,162,,,
356,70091,73293,151674,2522.534832826748,81583,157.6,3202,483,LARGE,169,,,
338,67629,68893,152592,2522.534832826748,84963,162.5,1264,504,LARGE,169,,,
267,53127,55534,152996,2522.534832826748,99869,153.2,2407,614,LARGE,163,,,
268,53368,55786,153002,2522.534832826748,99634,153.2,2418,615,LARGE,163,,,
292,58770,58778,153115,2522.534832826748,94345,152.7,8,617,LARGE,153,,,
491,97296,100652,153310,2522.534832826748,56014,146.2,3356,375,LARGE,150,,,
151,30055,31407,153400,2522.534832826748,123345,136.2,1352,835,LARGE,148,,,
155,30258,31688,153419,2522.534832826748,123161,136.2,1430,848,LARGE,146,,,
391,76998,79943,154295,2522.534832826748,77297,159.1,2945,464,LARGE,167,,,
341,68120,69048,154455,2522.534832826748,86335,159.5,928,522,LARGE,166,,,
444,87938,91089,155685,2522.534832826748,67747,150.2,3151,451,LARGE,151,,,
456,89671,91638,155798,2522.534832826748,66127,152.0,1967,428,LARGE,155,,,
212,41672,43539,157460,2522.534832826748,115788,142.2,1867,758,LARGE,153,,,
180,35410,35458,157705,2522.534832826748,122295,135.4,48,855,LARGE,144,,,
273,54518,56936,157883,2522.534832826748,103365,148.8,2418,671,LARGE,155,,,
284,56909,57575,157974,2522.534832826748,101065,146.3,666,687,LARGE,148,,,
288,57207,57866,158037,2522.534832826748,100830,148.3,659,660,LARGE,153,,,
461,90449,94496,158067,2522.534832826748,67618,141.8,4047,439,LARGE,155,,,
129,25315,25327,158647,2522.534832826748,133332,125.9,12,987,LARGE,136,,,
446,88059,91131,159839,2522.534832826748,71780,143.9,3072,506,LARGE,142,,,
392,77505,80027,160335,2522.534832826748,82830,150.7,2522,534,LARGE,156,,,
494,98015,101418,161031,2522.534832826748,63016,134.0,3403,462,LARGE,137,,,
331,66410,68588,161933,2522.534832826748,95523,148.7,2178,619,LARGE,155,,,
480,95273,98506,162441,2522.534832826748,67168,132.5,3233,483,LARGE,140,,,
304,61949,64595,162590,2522.534832826748,100641,142.4,2646,661,LARGE,153,,,
419,83764,87274,162832,2522.534832826748,79068,138.9,3510,550,LARGE,144,,,
207,40750,42551,163572,2522.534832826748,122822,138.3,1801,804,LARGE,153,,,
245,48660,48709,163694,2522.534832826748,115034,137.6,49,816,LARGE,141,,,
493,97958,101340,163945,2522.534832826748,65987,128.9,3382,519,LARGE,128,,,
448,88748,91307,164401,2522.534832826748,75653,135.6,2559,564,LARGE,135,,,
359,71368,74420,164492,2522.534832826748,93124,140.7,3052,617,LARGE,151,,,
363,71906,74963,164623,2522.534832826748,92717,140.8,3057,606,LARGE,153,,,
389,76436,79784,165055,2522.534832826748,88619,141.5,3348,595,LARGE,149,,,
390,76893,79922,165068,2522.534832826748,88175,141.6,3029,592,LARGE,149,,,
351,69604,70197,165518,2522.534832826748,95914,141.8,593,672,LARGE,143,,,
164,31300,32863,165674,2522.534832826748,134374,129.7,1563,980,LARGE,138,,,
169,33017,34531,165906,2522.534832826748,132889,129.4,1514,953,LARGE,140,,,
260,52102,54394,165983,2522.534832826748,113881,138.4,2292,784,LARGE,146,,,
286,56930,57617,166059,2522.534832826748,109129,138.0,687,783,LARGE,140,,,
463,90549,94559,166085,2522.534832826748,75536,127.7,4010,545,LARGE,139,,,
300,61524,64124,166513,2522.534832826748,104989,137.9,2600,711,LARGE,148,,,
327,66067,68441,166648,2522.534832826748,100581,138.3,2374,730,LARGE,138,,,
425,85111,88441,167208,2522.534832826748,82097,130.7,3330,618,LARGE,133,,,
362,71769,74832,167580,2522.534832826748,95811,135.5,3063,637,LARGE,151,,,
388,76117,79471,167950,2522.534832826748,91833,136.0,3354,635,LARGE,145,,,
278,55108,57146,168758,2522.534832826748,113650,133.9,2038,837,LARGE,136,,,
418,83534,87043,169649,2522.534832826748,86115,128.1,3509,636,LARGE,136,,,
229,45918,46217,170446,2522.534832826748,124528,127.4,299,932,LARGE,134,,,
205,39950,39998,171456,2522.534832826748,131506,124.0,48,991,LARGE,133,,,
405,80246,83817,171698,2522.534832826748,91452,120.2,3571,710,LARGE,129,,,
413,81891,85388,171784,2522.534832826748,89893,120.6,3497,701,LARGE,129,,,
347,69071,69756,172274,2522.534832826748,103203,128.9,685,786,LARGE,132,,,
209,41075,42891,172346,2522.534832826748,131271,125.3,1816,968,LARGE,136,,,
411,81527,84989,172667,2522.534832826748,91140,118.1,3462,725,LARGE,126,,,
427,85141,88519,172741,2522.534832826748,87600,118.5,3378,730,LARGE,120,,,
453,89282,91517,172813,2522.534832826748,83531,117.8,2235,708,LARGE,118,,,
232,46484,46508,173754,2522.534832826748,127270,122.2,24,984,LARGE,130,,,
257,51780,54033,173764,2522.534832826748,121984,124.2,2253,929,LARGE,132,,,
469,92104,95693,173858,2522.534832826748,81754,108.3,3589,720,LARGE,114,,,
482,95645,98884,173946,2522.534832826748,78301,107.7,3239,714,LARGE,110,,,
408,81018,84422,174339,2522.534832826748,93321,115.8,3404,768,LARGE,122,,,
421,84214,87547,174542,2522.534832826748,90328,114.1,3333,785,LARGE,116,,,
374,73914,77093,174914,2522.534832826748,101000,118.5,3179,797,LARGE,127,,,
382,75367,78631,175008,2522.534832826748,99641,116.4,3264,830,LARGE,121,,,
400,79113,80501,175218,2522.534832826748,96105,119.2,1388,791,LARGE,122,,,
334,66691,68672,175252,2522.534832826748,108561,119.7,1981,882,LARGE,124,,,
344,68823,69567,175307,2522.534832826748,106484,122.1,744,852,LARGE,125,,,
467,91857,95420,175469,2522.534832826748,83612,105.9,3563,735,LARGE,114,,,
420,84171,87505,175994,2522.534832826748,91823,111.8,3334,794,LARGE,116,,,
360,71674,74719,176248,2522.534832826748,104574,111.9,3045,884,LARGE,119,,,
364,72070,75151,176286,2522.534832826748,104216,111.7,3081,876,LARGE,119,,,
384,75630,78925,176464,2522.534832826748,100834,114.2,3295,861,LARGE,118,,,
393,77762,80069,176490,2522.534832826748,98728,114.6,2307,865,LARGE,115,,,
336,67029,68758,176562,2522.534832826748,109533,117.4,1729,919,LARGE,120,,,
348,69198,69819,176602,2522.534832826748,107404,115.4,621,938,LARGE,115,,,
352,69660,70239,176612,2522.534832826748,106952,118.0,579,909,LARGE,118,,,
473,92256,95924,176682,2522.534832826748,84426,101.4,3668,797,LARGE,106,,,
299,61511,64082,176864,2522.534832826748,115353,114.2,2571,985,LARGE,118,,,
315,63306,66149,176882,2522.534832826748,113576,114.3,2843,977,LARGE,117,,,
322,65057,67965,176893,2522.534832826748,111836,114.5,2908,970,LARGE,116,,,
409,81168,84590,176949,2522.534832826748,95781,106.8,3422,843,LARGE,114,,,
435,85928,89464,177074,2522.534832826748,91146,105.5,3536,850,LARGE,108,,,
383,75403,78694,177332,2522.534832826748,101929,107.3,3291,938,LARGE,109,,,
396,78667,80354,177362,2522.534832826748,98695,109.9,1687,919,LARGE,108,,,
353,69766,70310,177403,2522.534832826748,107637,110.5,544,979,LARGE,110,,,
414,82024,85535,177652,2522.534832826748,95628,100.3,3511,929,LARGE,103,,,
430,85383,88813,177685,2522.534832826748,92302,98.7,3430,911,LARGE,102,,,
457,89860,91716,177746,2522.534832826748,87886,100.1,1856,888,LARGE,99,,,
370,73030,76241,177766,2522.534832826748,104736,105.0,3211,959,LARGE,110,,,
378,74604,77825,177794,2522.534832826748,103190,105.0,3221,967,LARGE,107,,,
485,95875,99171,177864,2522.534832826748,81989,92.0,3296,897,LARGE,92,,,
406,80376,83929,177967,2522.534832826748,97591,95.8,3553,989,LARGE,99,,,
483,95766,99024,178040,2522.534832826748,82274,88.0,3258,950,LARGE,87,,,
497,98869,101718,178053,2522.534832826748,79184,87.2,2849,942,LARGE,85,,,
441,87428,90879,178064,2522.534832826748,90636,92.5,3451,990,LARGE,92,,,
