pids,instantiation times,start times,finish times,average wait times,turnaround times,average queue lengths,response times,required cpu times,process sizes,turnaround times,efficiency,average response time,average queue length
2,70,125,248,149.67761066470712,178,4.5,55,38,TINY,5,0.9509050492219753,4117.35,216
3,104,188,705,149.67761066470712,601,10.5,84,75,SMALL,9,,,
11,387,606,955,149.67761066470712,568,21.0,219,38,TINY,15,,,
17,607,956,968,149.67761066470712,361,26.0,349,12,TINY,31,,,
13,447,706,1142,149.67761066470712,695,23.5,259,25,TINY,28,,,
25,813,1290,1309,149.67761066470712,496,29.0,477,19,TINY,27,,,
28,893,1415,1433,149.67761066470712,540,34.0,522,18,TINY,30,,,
37,1341,2001,2013,149.67761066470712,672,49.0,660,12,TINY,56,,,
41,1415,2140,2155,149.67761066470712,740,49.0,725,15,TINY,50,,,
50,1909,2807,2820,149.67761066470712,911,67.0,898,13,TINY,71,,,
26,838,1331,2907,149.67761066470712,2069,47.3,493,42,TINY,50,,,
38,1370,2035,3038,149.67761066470712,1668,61.0,665,24,TINY,70,,,
20,636,1032,3335,149.67761066470712,2699,47.2,396,62,SMALL,44,,,
30,1088,1623,3411,149.67761066470712,2323,55.3,535,52,SMALL,45,,,
63,2418,3475,3485,149.67761066470712,1067,79.0,1057,10,TINY,107,,,
46,1739,2555,3716,149.67761066470712,1977,70.5,816,40,TINY,50,,,
8,330,480,3818,149.67761066470712,3488,40.3,150,117,SMALL,30,,,
49,1817,2702,3946,149.67761066470712,2129,74.0,885,21,TINY,102,,,
54,1988,2950,4312,149.67761066470712,2324,80.0,962,28,TINY,83,,,
5,156,270,4882,149.67761066470712,4726,40.1,114,142,SMALL,34,,,
60,2257,3291,4899,149.67761066470712,2642,89.5,1034,36,TINY,74,,,
93,3384,5005,5016,149.67761066470712,1632,105.0,1621,11,TINY,149,,,
61,2387,3433,5057,149.67761066470712,2670,92.5,1046,39,TINY,69,,,
71,2640,3861,5589,149.67761066470712,2949,99.5,1221,26,TINY,114,,,
9,350,522,5835,149.67761066470712,5485,53.7,172,134,SMALL,41,,,
110,4287,6151,6168,149.67761066470712,1881,124.0,1864,17,TINY,111,,,
81,2969,4334,6222,149.67761066470712,3253,108.0,1365,31,TINY,105,,,
83,2983,4397,6300,149.67761066470712,3317,108.0,1414,34,TINY,98,,,
14,580,853,6366,149.67761066470712,5786,65.5,273,102,SMALL,57,,,
85,3013,4502,6423,149.67761066470712,3410,109.0,1489,34,TINY,101,,,
89,3248,4796,6864,149.67761066470712,3616,117.0,1548,40,TINY,91,,,
123,4960,7033,7050,149.67761066470712,2090,134.0,2073,17,TINY,123,,,
96,3600,5247,7484,149.67761066470712,3884,127.0,1647,33,TINY,118,,,
132,5265,7485,7495,149.67761066470712,2230,146.0,2220,10,TINY,223,,,
104,3959,5716,8149,149.67761066470712,4190,137.0,1757,22,TINY,191,,,
107,4039,5857,8317,149.67761066470712,4278,140.0,1818,40,TINY,107,,,
80,2962,4313,8739,149.67761066470712,5777,127.3,1351,41,TINY,141,,,
114,4511,6424,8974,149.67761066470712,4463,145.0,1913,23,TINY,195,,,
156,6481,9059,9069,149.67761066470712,2588,169.0,2578,10,TINY,259,,,
117,4736,6718,9433,149.67761066470712,4697,155.0,1982,26,TINY,181,,,
118,4742,6739,9452,149.67761066470712,4710,154.5,1997,38,TINY,124,,,
121,4913,6949,9700,149.67761066470712,4787,157.5,2036,36,TINY,133,,,
64,2422,3486,10133,149.67761066470712,7711,130.5,1064,72,SMALL,108,,,
174,7242,10134,10145,149.67761066470712,2903,198.0,2892,11,TINY,264,,,
94,3514,5121,10195,149.67761066470712,6681,148.7,1607,47,TINY,143,,,
175,7327,10217,10230,149.67761066470712,2903,197.0,2890,13,TINY,224,,,
95,3593,5226,10366,149.67761066470712,6773,150.7,1633,49,TINY,139,,,
131,5230,7450,10384,149.67761066470712,5154,172.0,2220,37,TINY,140,,,
138,5573,7916,10955,149.67761066470712,5382,181.0,2343,23,TINY,234,,,
185,7948,10977,10988,149.67761066470712,3040,211.0,3029,11,TINY,277,,,
139,5595,7958,10998,149.67761066470712,5403,180.5,2363,29,TINY,187,,,
191,8151,11272,11291,149.67761066470712,3140,217.0,3121,19,TINY,166,,,
74,2744,4010,11435,149.67761066470712,8691,146.2,1266,77,SMALL,113,,,
106,4031,5836,11469,149.67761066470712,7438,165.7,1805,52,SMALL,144,,,
148,5948,8465,11744,149.67761066470712,5796,195.5,2517,21,TINY,276,,,
111,4307,6169,12011,149.67761066470712,7704,176.3,1862,54,SMALL,143,,,
27,887,1394,12496,149.67761066470712,11609,113.9,507,121,SMALL,96,,,
16,604,916,12735,149.67761066470712,12131,104.5,312,147,SMALL,83,,,
214,9319,12820,12834,149.67761066470712,3515,256.0,3501,14,TINY,252,,,
229,9831,13612,13627,149.67761066470712,3796,267.0,3781,15,TINY,254,,,
166,7117,9848,13668,149.67761066470712,6551,227.0,2731,39,TINY,168,,,
236,9980,13900,13919,149.67761066470712,3939,270.0,3920,19,TINY,208,,,
170,7200,10016,13949,149.67761066470712,6749,232.0,2816,28,TINY,242,,,
172,7211,10058,14005,149.67761066470712,6794,232.5,2847,33,TINY,206,,,
173,7218,10079,14035,149.67761066470712,6817,233.0,2861,28,TINY,244,,,
65,2445,3528,14217,149.67761066470712,11772,159.8,1083,93,SMALL,127,,,
97,3617,5289,14563,149.67761066470712,10946,184.0,1672,69,SMALL,159,,,
250,10585,14669,14683,149.67761066470712,4098,285.0,4084,14,TINY,293,,,
252,10613,14726,14744,149.67761066470712,4131,285.0,4113,18,TINY,230,,,
253,10616,14766,14780,149.67761066470712,4164,286.0,4150,14,TINY,298,,,
69,2557,3738,14839,149.67761066470712,12282,166.4,1181,96,SMALL,128,,,
134,5445,7706,14896,149.67761066470712,9451,214.0,2261,54,SMALL,176,,,
184,7778,10805,15017,149.67761066470712,7239,249.5,3027,35,TINY,207,,,
257,10882,15081,15095,149.67761066470712,4213,290.0,4199,14,TINY,301,,,
186,7971,10999,15254,149.67761066470712,7283,250.5,3028,31,TINY,235,,,
187,7995,11041,15324,149.67761066470712,7329,253.0,3046,26,TINY,282,,,
198,8325,11554,16101,149.67761066470712,7776,271.5,3229,40,TINY,195,,,
147,5948,8444,16347,149.67761066470712,10399,238.0,2496,54,SMALL,193,,,
290,11847,16600,16612,149.67761066470712,4765,327.0,4753,12,TINY,398,,,
296,11998,16865,16875,149.67761066470712,4877,334.0,4867,10,TINY,488,,,
205,8973,12306,17320,149.67761066470712,8347,298.5,3333,23,TINY,363,,,
206,9039,12432,17490,149.67761066470712,8451,303.0,3393,21,TINY,403,,,
309,12490,17596,17611,149.67761066470712,5121,360.0,5106,15,TINY,342,,,
15,591,895,17711,149.67761066470712,17120,131.8,304,175,SMALL,98,,,
209,9215,12623,17777,149.67761066470712,8562,307.0,3408,22,TINY,390,,,
115,4697,6634,17984,149.67761066470712,13287,231.2,1937,77,SMALL,173,,,
222,9609,13255,18600,149.67761066470712,8991,320.5,3646,26,TINY,346,,,
228,9790,13549,18945,149.67761066470712,9155,327.0,3759,28,TINY,327,,,
230,9837,13628,19015,149.67761066470712,9178,328.0,3791,26,TINY,353,,,
240,10107,14078,19588,149.67761066470712,9481,337.0,3971,25,TINY,380,,,
130,5123,7324,19733,149.67761066470712,14610,253.8,2201,78,SMALL,188,,,
43,1702,2450,19838,149.67761066470712,18136,180.0,748,140,SMALL,130,,,
344,14405,20007,20020,149.67761066470712,5615,407.0,5602,13,TINY,432,,,
346,14493,20147,20163,149.67761066470712,5670,406.0,5654,16,TINY,355,,,
248,10474,14533,20199,149.67761066470712,9725,342.5,4059,34,TINY,287,,,
254,10645,14802,20585,149.67761066470712,9940,344.5,4157,27,TINY,369,,,
357,14848,20628,20643,149.67761066470712,5795,403.0,5780,15,TINY,387,,,
70,2589,3780,20815,149.67761066470712,18226,207.0,1191,103,SMALL,177,,,
362,14974,20816,20827,149.67761066470712,5853,401.0,5842,11,TINY,533,,,
259,10943,15180,21073,149.67761066470712,10130,345.0,4237,34,TINY,298,,,
261,10999,15255,21176,149.67761066470712,10177,345.0,4256,38,TINY,268,,,
262,11002,15276,21216,149.67761066470712,10214,345.0,4274,38,TINY,269,,,
375,15479,21553,21563,149.67761066470712,6084,397.0,6074,10,TINY,609,,,
377,15568,21669,21689,149.67761066470712,6121,396.0,6101,20,TINY,307,,,
194,8178,11355,22009,149.67761066470712,13831,306.7,3177,44,TINY,315,,,
289,11828,16579,23215,149.67761066470712,11387,360.0,4751,28,TINY,407,,,
294,11965,16802,23545,149.67761066470712,11580,362.0,4837,34,TINY,341,,,
412,16838,23588,23607,149.67761066470712,6769,392.0,6750,19,TINY,357,,,
417,16957,23797,23816,149.67761066470712,6859,391.0,6840,19,TINY,361,,,
4,112,209,24620,149.67761066470712,24508,117.2,97,245,LARGE,101,,,
208,9094,12497,24938,149.67761066470712,15844,333.3,3403,42,TINY,378,,,
39,1398,2098,24984,149.67761066470712,23586,189.2,700,143,SMALL,165,,,
58,2161,3165,25176,149.67761066470712,23015,210.1,1004,122,SMALL,189,,,
314,12705,17883,25231,149.67761066470712,12526,373.5,5178,32,TINY,392,,,
210,9271,12707,25250,149.67761066470712,15979,334.3,3436,58,SMALL,276,,,
319,13071,18342,25979,149.67761066470712,12908,379.0,5271,34,TINY,380,,,
465,18654,26358,26370,149.67761066470712,7716,383.0,7704,12,TINY,643,,,
231,9851,13669,26996,149.67761066470712,17145,345.3,3818,56,SMALL,307,,,
482,19172,27186,27199,149.67761066470712,8027,381.0,8014,13,TINY,618,,,
332,13901,19352,27404,149.67761066470712,13503,387.0,5451,35,TINY,386,,,
342,14256,19839,28085,149.67761066470712,13829,390.5,5583,28,TINY,494,,,
495,19932,28170,28190,149.67761066470712,8258,378.0,8238,20,TINY,413,,,
343,14348,19965,28270,149.67761066470712,13922,391.0,5617,36,TINY,387,,,
498,19989,28292,28310,149.67761066470712,8321,376.0,8303,18,TINY,463,,,
178,7458,10385,28342,149.67761066470712,20884,314.2,2927,70,SMALL,299,,,
181,7492,10448,28435,149.67761066470712,20943,314.5,2956,68,SMALL,308,,,
352,14614,20368,28630,149.67761066470712,14016,388.5,5754,25,TINY,561,,,
182,7583,10574,28658,149.67761066470712,21075,315.5,2991,66,SMALL,320,,,
356,14820,20586,28822,149.67761066470712,14002,387.0,5766,36,TINY,389,,,
359,14897,20707,28916,149.67761066470712,14019,386.0,5810,29,TINY,484,,,
363,14976,20828,29013,149.67761066470712,14037,384.5,5852,32,TINY,439,,,
260,10945,15201,29227,149.67761066470712,18282,352.3,4256,43,TINY,426,,,
365,15208,21095,29230,149.67761066470712,14022,383.0,5887,22,TINY,638,,,
265,11118,15430,29569,149.67761066470712,18451,353.7,4312,42,TINY,440,,,
382,15675,21879,29908,149.67761066470712,14233,380.0,6204,22,TINY,647,,,
270,11363,15766,30044,149.67761066470712,18681,355.7,4403,49,TINY,382,,,
387,15787,22094,30103,149.67761066470712,14316,378.5,6307,36,TINY,398,,,
272,11370,15808,30174,149.67761066470712,18804,356.7,4438,47,TINY,401,,,
195,8249,11436,30252,149.67761066470712,22003,322.2,3187,74,SMALL,298,,,
394,15969,22409,30386,149.67761066470712,14417,377.0,6440,27,TINY,534,,,
275,11497,15976,30395,149.67761066470712,18898,357.0,4479,48,TINY,394,,,
276,11517,16018,30439,149.67761066470712,18922,357.0,4501,41,TINY,462,,,
279,11645,16207,30708,149.67761066470712,19063,358.0,4562,56,SMALL,341,,,
281,11687,16291,30785,149.67761066470712,19098,357.7,4604,53,SMALL,361,,,
403,16443,23039,30956,149.67761066470712,14513,374.5,6596,22,TINY,660,,,
418,16958,23817,31658,149.67761066470712,14700,372.0,6859,28,TINY,525,,,
422,17077,24027,31849,149.67761066470712,14772,371.5,6950,21,TINY,704,,,
423,17115,24090,31912,149.67761066470712,14797,371.0,6975,40,TINY,370,,,
429,17283,24384,32205,149.67761066470712,14922,370.5,7101,39,TINY,383,,,
303,12351,17363,32328,149.67761066470712,19977,363.3,5012,57,SMALL,351,,,
311,12600,17733,32842,149.67761066470712,20242,365.3,5133,49,TINY,414,,,
158,6576,9196,32858,149.67761066470712,26282,303.6,2620,95,SMALL,277,,,
450,17940,25335,33079,149.67761066470712,15139,365.5,7395,30,TINY,505,,,
87,3189,4712,33292,149.67761066470712,30103,251.0,1523,122,SMALL,247,,,
226,9782,13486,34324,149.67761066470712,24542,344.2,3704,62,SMALL,396,,,
477,18962,26896,34511,149.67761066470712,15549,363.0,7934,38,TINY,410,,,
31,1091,1644,35027,149.67761066470712,33936,198.8,553,191,SMALL,178,,,
171,7208,10037,35073,149.67761066470712,27865,316.0,2829,83,SMALL,336,,,
489,19521,27699,35286,149.67761066470712,15765,360.0,8178,22,TINY,717,,,
499,19996,28311,35809,149.67761066470712,15813,357.5,8315,38,TINY,417,,,
180,7490,10427,35891,149.67761066470712,28401,319.4,2937,98,SMALL,290,,,
251,10586,14684,36138,149.67761066470712,25552,349.2,4098,75,SMALL,341,,,
82,2972,4376,39036,149.67761066470712,36064,255.2,1404,160,SMALL,226,,,
84,2983,4418,39190,149.67761066470712,36207,255.9,1435,146,SMALL,248,,,
425,17200,24216,39277,149.67761066470712,22077,358.7,7016,42,TINY,526,,,
426,17211,24237,39290,149.67761066470712,22079,358.3,7026,52,SMALL,425,,,
427,17219,24279,39316,149.67761066470712,22097,358.0,7060,44,TINY,503,,,
452,17967,25398,40266,149.67761066470712,22299,354.0,7431,44,TINY,507,,,
162,6680,9385,40528,149.67761066470712,33848,310.7,2705,109,SMALL,311,,,
468,18714,26476,41202,149.67761066470712,22488,352.3,7762,41,TINY,549,,,
481,19118,27123,41842,149.67761066470712,22724,351.0,8005,49,TINY,464,,,
349,14578,20263,43017,149.67761066470712,28439,360.8,5685,79,SMALL,360,,,
136,5485,7790,43437,149.67761066470712,37952,297.1,2305,140,SMALL,272,,,
367,15275,21177,43614,149.67761066470712,28339,356.8,5902,68,SMALL,417,,,
190,8138,11230,44095,149.67761066470712,35957,323.5,3092,118,SMALL,305,,,
268,11264,15640,44160,149.67761066470712,32896,345.2,4376,81,SMALL,407,,,
105,3978,5758,44513,149.67761066470712,40535,278.4,1780,156,SMALL,260,,,
274,11488,15934,44602,149.67761066470712,33114,345.8,4446,84,SMALL,395,,,
400,16197,22745,44902,149.67761066470712,28705,352.2,6548,65,SMALL,442,,,
409,16733,23426,45484,149.67761066470712,28751,351.0,6693,74,SMALL,389,,,
203,8748,12054,45835,149.67761066470712,37087,329.7,3306,114,SMALL,326,,,
298,12131,17044,45968,149.67761066470712,33837,347.4,4913,86,SMALL,394,,,
424,17163,24153,46076,149.67761066470712,28913,348.2,6990,62,SMALL,467,,,
430,17292,24405,46243,149.67761066470712,28951,347.0,7113,79,SMALL,367,,,
457,18130,25671,47312,149.67761066470712,29182,343.8,7541,78,SMALL,375,,,
459,18156,25755,47385,149.67761066470712,29229,343.2,7599,69,SMALL,424,,,
221,9582,13213,47802,149.67761066470712,38220,335.2,3631,117,SMALL,327,,,
361,14929,20770,50065,149.67761066470712,35136,349.4,5841,95,SMALL,370,,,
396,16042,22535,51386,149.67761066470712,35344,344.0,6493,98,SMALL,361,,,
199,8413,11659,51565,149.67761066470712,43152,323.6,3246,130,SMALL,332,,,
405,16594,23216,51933,149.67761066470712,35339,342.6,6622,90,SMALL,393,,,
292,11913,16718,52077,149.67761066470712,40164,340.2,4805,117,SMALL,344,,,
150,6187,8717,52295,149.67761066470712,46108,305.9,2530,147,SMALL,314,,,
416,16948,23776,52369,149.67761066470712,35421,341.4,6828,90,SMALL,394,,,
310,12505,17633,53313,149.67761066470712,40808,341.3,5128,119,SMALL,343,,,
90,3250,4838,54312,149.67761066470712,51062,272.8,1588,191,SMALL,268,,,
124,4960,7051,54593,149.67761066470712,49633,292.7,2091,167,SMALL,298,,,
331,13775,19226,55185,149.67761066470712,41410,343.0,5451,103,SMALL,403,,,
167,7170,9911,55194,149.67761066470712,48024,314.9,2741,148,SMALL,325,,,
486,19452,27531,55417,149.67761066470712,35965,332.0,8079,92,SMALL,391,,,
245,10273,14302,55930,149.67761066470712,45657,333.6,4029,128,SMALL,357,,,
355,14758,20536,56316,149.67761066470712,41558,341.5,5778,107,SMALL,389,,,
360,14928,20749,56405,149.67761066470712,41477,340.7,5821,104,SMALL,399,,,
47,1785,2618,56566,149.67761066470712,54781,245.2,833,233,LARGE,236,,,
371,15362,21343,56771,149.67761066470712,41409,338.5,5981,115,SMALL,361,,,
389,15792,22136,57543,149.67761066470712,41751,336.8,6344,115,SMALL,364,,,
36,1331,1980,58654,149.67761066470712,57323,235.0,649,258,LARGE,223,,,
300,12183,17149,58900,149.67761066470712,46717,333.3,4966,134,SMALL,349,,,
431,17305,24447,59043,149.67761066470712,41738,330.5,7142,116,SMALL,360,,,
313,12655,17820,59659,149.67761066470712,47004,333.4,5165,126,SMALL,374,,,
445,17870,25177,59684,149.67761066470712,41814,328.8,7307,103,SMALL,406,,,
456,18124,25650,60043,149.67761066470712,41919,327.8,7526,101,SMALL,416,,,
318,13009,18258,60184,149.67761066470712,47175,333.7,5249,134,SMALL,353,,,
165,6936,9663,60601,149.67761066470712,53665,309.2,2727,177,SMALL,304,,,
496,19949,28212,62139,149.67761066470712,42190,323.3,8263,104,SMALL,406,,,
350,14591,20305,62331,149.67761066470712,47740,333.7,5714,122,SMALL,392,,,
256,10740,14918,62485,149.67761066470712,51745,326.8,4178,146,SMALL,355,,,
188,8026,11104,62788,149.67761066470712,54762,313.3,3078,168,SMALL,326,,,
376,15519,21606,62924,149.67761066470712,47405,329.9,6087,129,SMALL,368,,,
100,3848,5541,62979,149.67761066470712,59131,280.0,1693,212,LARGE,279,,,
192,8157,11292,63194,149.67761066470712,55037,314.0,3135,164,SMALL,336,,,
392,15881,22283,63608,149.67761066470712,47727,327.9,6402,134,SMALL,357,,,
399,16157,22682,63829,149.67761066470712,47672,327.0,6525,130,SMALL,367,,,
402,16410,22976,64004,149.67761066470712,47594,326.3,6566,126,SMALL,378,,,
288,11822,16558,64169,149.67761066470712,52347,326.0,4736,157,SMALL,334,,,
151,6287,8803,64786,149.67761066470712,58499,301.8,2516,187,SMALL,313,,,
302,12233,17233,64848,149.67761066470712,52615,325.6,5000,159,SMALL,331,,,
213,9308,12799,65681,149.67761066470712,56373,318.0,3491,173,SMALL,326,,,
112,4369,6244,65833,149.67761066470712,61464,285.0,1875,204,LARGE,302,,,
323,13268,18601,66343,149.67761066470712,53075,325.8,5333,145,SMALL,367,,,
470,18856,26665,66549,149.67761066470712,47693,317.7,7809,136,SMALL,351,,,
88,3229,4775,67446,149.67761066470712,64217,272.8,1546,234,LARGE,275,,,
335,14052,19520,67546,149.67761066470712,53494,326.2,5468,155,SMALL,346,,,
494,19788,28035,67812,149.67761066470712,48024,315.6,8247,133,SMALL,362,,,
249,10552,14606,68100,149.67761066470712,57548,320.3,4054,174,SMALL,331,,,
183,7702,10700,68174,149.67761066470712,60472,308.4,2998,190,SMALL,319,,,
369,15289,21238,68365,149.67761066470712,53076,322.0,5949,141,SMALL,377,,,
99,3813,5478,68573,149.67761066470712,64760,278.4,1665,238,LARGE,273,,,
420,17013,23922,70266,149.67761066470712,53253,316.1,6909,152,SMALL,351,,,
446,17876,25198,71016,149.67761066470712,53140,313.0,7322,154,SMALL,346,,,
464,18489,26190,71867,149.67761066470712,53378,311.2,7701,150,SMALL,356,,,
237,10021,13950,72623,149.67761066470712,62602,313.5,3929,200,SMALL,314,,,
484,19406,27447,72643,149.67761066470712,53237,308.9,8041,159,SMALL,335,,,
341,14228,19797,73347,149.67761066470712,59119,318.6,5569,170,SMALL,348,,,
244,10260,14260,73366,149.67761066470712,63106,314.0,4000,198,SMALL,319,,,
179,7478,10406,74420,149.67761066470712,66942,303.4,2928,203,LARGE,330,,,
432,17374,24531,75800,149.67761066470712,58426,307.3,7157,174,SMALL,336,,,
434,17399,24594,75986,149.67761066470712,58587,307.2,7195,177,SMALL,331,,,
438,17468,24726,76185,149.67761066470712,58717,307.0,7258,169,SMALL,348,,,
308,12478,17575,76323,149.67761066470712,63845,312.2,5097,191,SMALL,335,,,
474,18924,26812,77510,149.67761066470712,58586,303.2,7888,170,SMALL,345,,,
328,13682,19058,77755,149.67761066470712,64073,311.7,5376,193,SMALL,332,,,
91,3255,4859,78105,149.67761066470712,74850,270.3,1604,273,LARGE,275,,,
92,3368,4963,78121,149.67761066470712,74753,271.0,1595,275,LARGE,272,,,
168,7175,9932,78174,149.67761066470712,70999,297.7,2757,230,LARGE,309,,,
354,14727,20494,78867,149.67761066470712,64140,309.4,5767,200,SMALL,321,,,
388,15792,22115,79707,149.67761066470712,63915,305.6,6323,200,SMALL,320,,,
33,1194,1791,79736,149.67761066470712,78542,236.0,597,327,LARGE,241,,,
48,1794,2660,79891,149.67761066470712,78097,248.6,866,307,LARGE,255,,,
407,16707,23363,80297,149.67761066470712,63590,303.3,6656,186,SMALL,342,,,
144,5842,8276,80501,149.67761066470712,74659,288.0,2434,254,LARGE,294,,,
433,17378,24552,80814,149.67761066470712,63436,300.3,7174,198,SMALL,321,,,
436,17414,24642,80979,149.67761066470712,63565,300.0,7228,197,SMALL,323,,,
443,17643,24960,81196,149.67761066470712,63553,299.5,7317,186,SMALL,342,,,
461,18367,26001,82056,149.67761066470712,63689,297.4,7634,199,SMALL,321,,,
164,6883,9579,83199,149.67761066470712,76316,291.2,2696,248,LARGE,308,,,
145,5937,8381,85215,149.67761066470712,79278,284.4,2444,280,LARGE,284,,,
55,1989,2971,86011,149.67761066470712,84022,251.2,982,338,LARGE,249,,,
0,40,41,86628,149.67761066470712,86588,167.7,1,507,LARGE,171,,,
212,9296,12757,86715,149.67761066470712,77419,294.9,3461,242,LARGE,320,,,
128,5014,7177,87660,149.67761066470712,82646,278.2,2163,300,LARGE,276,,,
358,14869,20665,89125,149.67761066470712,74256,295.8,5796,235,LARGE,316,,,
380,15625,21795,89350,149.67761066470712,73725,293.6,6170,234,LARGE,316,,,
193,8174,11334,89492,149.67761066470712,81318,288.7,3160,275,LARGE,296,,,
258,10914,15138,89681,149.67761066470712,78767,294.1,4224,260,LARGE,303,,,
391,15853,22241,90400,149.67761066470712,74547,292.2,6388,224,LARGE,333,,,
312,12652,17799,91172,149.67761066470712,78520,292.6,5147,255,LARGE,308,,,
116,4706,6655,91218,149.67761066470712,86512,272.6,1949,303,LARGE,286,,,
473,18923,26791,92138,149.67761066470712,73215,284.4,7868,236,LARGE,311,,,
243,10244,14218,92876,149.67761066470712,82632,290.4,3974,262,LARGE,316,,,
44,1706,2471,92921,149.67761066470712,91215,244.1,765,362,LARGE,252,,,
18,619,969,93149,149.67761066470712,92530,221.2,350,417,LARGE,222,,,
487,19489,27594,93426,149.67761066470712,73937,282.8,8105,223,LARGE,332,,,
79,2938,4283,94837,149.67761066470712,91899,258.1,1345,343,LARGE,268,,,
10,375,585,96438,149.67761066470712,96063,210.0,210,444,LARGE,217,,,
458,18151,25713,96519,149.67761066470712,78368,280.1,7562,257,LARGE,305,,,
330,13717,19142,97109,149.67761066470712,83392,286.5,5425,261,LARGE,320,,,
385,15765,22010,98572,149.67761066470712,82807,281.9,6245,273,LARGE,304,,,
153,6371,8929,100305,149.67761066470712,93934,272.8,2558,330,LARGE,285,,,
345,14426,20042,102640,149.67761066470712,88214,280.2,5616,283,LARGE,312,,,
177,7403,10315,103009,149.67761066470712,95606,275.0,2912,331,LARGE,289,,,
157,6572,9175,104686,149.67761066470712,98114,269.9,2603,357,LARGE,275,,,
439,17499,24768,105147,149.67761066470712,87648,272.0,7269,299,LARGE,294,,,
133,5327,7559,106377,149.67761066470712,101050,264.7,2232,371,LARGE,273,,,
347,14568,20221,107021,149.67761066470712,92453,275.2,5653,313,LARGE,296,,,
7,325,459,107103,149.67761066470712,106778,205.4,134,518,LARGE,207,,,
370,15311,21280,107178,149.67761066470712,91867,273.2,5969,311,LARGE,296,,,
372,15375,21385,107182,149.67761066470712,91807,273.1,6010,303,LARGE,303,,,
278,11604,16144,107549,149.67761066470712,95945,273.9,4540,329,LARGE,292,,,
34,1213,1833,107632,149.67761066470712,106419,231.7,620,459,LARGE,232,,,
142,5697,8126,112029,149.67761066470712,106332,261.0,2429,387,LARGE,275,,,
197,8298,11512,112133,149.67761066470712,103835,266.7,3214,379,LARGE,274,,,
295,11990,16844,112808,149.67761066470712,100818,268.9,4854,342,LARGE,295,,,
207,9039,12453,113253,149.67761066470712,104214,267.4,3414,363,LARGE,288,,,
440,17524,24810,113553,149.67761066470712,96029,263.1,7286,325,LARGE,296,,,
492,19582,27804,115240,149.67761066470712,95658,259.2,8222,326,LARGE,294,,,
368,15286,21217,115506,149.67761066470712,100220,264.7,5931,353,LARGE,284,,,
266,11133,15472,115744,149.67761066470712,104611,265.7,4339,366,LARGE,286,,,
219,9466,13045,117414,149.67761066470712,107948,263.7,3579,390,LARGE,277,,,
1,42,83,117528,149.67761066470712,117486,182.1,41,628,LARGE,188,,,
326,13574,18967,118231,149.67761066470712,104657,263.6,5393,369,LARGE,284,,,
293,11928,16739,120750,149.67761066470712,108822,260.9,4811,399,LARGE,273,,,
86,3076,4565,121282,149.67761066470712,118206,243.5,1489,466,LARGE,254,,,
462,18433,26085,121545,149.67761066470712,103112,253.7,7652,370,LARGE,279,,,
322,13237,18573,121958,149.67761066470712,108721,259.6,5336,393,LARGE,277,,,
215,9383,12898,122083,149.67761066470712,112700,259.8,3515,419,LARGE,269,,,
140,5641,8021,123005,149.67761066470712,117364,252.2,2380,458,LARGE,257,,,
336,14073,19562,123173,149.67761066470712,109100,258.9,5489,400,LARGE,273,,,
390,15805,22157,124138,149.67761066470712,108333,254.9,6352,399,LARGE,272,,,
196,8257,11470,124603,149.67761066470712,116346,255.6,3213,422,LARGE,276,,,
59,2193,3207,124834,149.67761066470712,122641,235.3,1014,520,LARGE,236,,,
77,2872,4178,124881,149.67761066470712,122009,240.1,1306,484,LARGE,253,,,
301,12184,17170,125285,149.67761066470712,113101,256.7,4986,404,LARGE,280,,,
152,6294,8824,125561,149.67761066470712,119267,251.8,2530,442,LARGE,270,,,
98,3668,5352,126149,149.67761066470712,122481,243.2,1684,500,LARGE,245,,,
491,19538,27741,126878,149.67761066470712,107340,247.5,8203,394,LARGE,273,,,
103,3945,5674,127460,149.67761066470712,123515,243.4,1729,494,LARGE,251,,,
408,16713,23384,128074,149.67761066470712,111361,249.9,6671,404,LARGE,276,,,
413,16854,23629,128128,149.67761066470712,111274,249.7,6775,411,LARGE,271,,,
57,2071,3060,128432,149.67761066470712,126361,232.3,989,529,LARGE,239,,,
291,11864,16634,128594,149.67761066470712,116730,252.9,4770,434,LARGE,269,,,
299,12135,17065,128649,149.67761066470712,116514,252.8,4930,432,LARGE,270,,,
304,12354,17384,128652,149.67761066470712,116298,252.5,5030,422,LARGE,276,,,
154,6436,8975,128718,149.67761066470712,122282,248.1,2539,462,LARGE,265,,,
160,6587,9238,128773,149.67761066470712,122186,248.6,2651,472,LARGE,259,,,
437,17419,24663,129185,149.67761066470712,111766,248.0,7244,412,LARGE,272,,,
444,17658,24985,129242,149.67761066470712,111584,246.8,7327,414,LARGE,270,,,
447,17922,25251,129246,149.67761066470712,111324,246.3,7329,403,LARGE,277,,,
454,18028,25524,129332,149.67761066470712,111304,246.1,7496,401,LARGE,278,,,
467,18696,26434,129434,149.67761066470712,110738,245.2,7738,417,LARGE,266,,,
119,4770,6781,129772,149.67761066470712,125002,243.4,2011,481,LARGE,260,,,
163,6832,9537,130202,149.67761066470712,123370,248.0,2705,469,LARGE,264,,,
176,7369,10273,130234,149.67761066470712,122865,249.0,2904,470,LARGE,262,,,
68,2556,3717,130322,149.67761066470712,127766,233.0,1161,523,LARGE,245,,,
263,11048,15325,130368,149.67761066470712,119320,249.7,4277,443,LARGE,270,,,
485,19425,27489,130799,149.67761066470712,111374,243.5,8064,410,LARGE,272,,,
351,14612,20347,131088,149.67761066470712,116476,249.3,5735,435,LARGE,268,,,
366,15211,21116,131150,149.67761066470712,115939,248.2,5905,439,LARGE,265,,,
211,9294,12736,132121,149.67761066470712,122827,247.7,3442,464,LARGE,265,,,
321,13152,18468,133239,149.67761066470712,120087,246.8,5316,444,LARGE,271,,,
66,2496,3612,133449,149.67761066470712,130953,229.9,1116,560,LARGE,234,,,
67,2522,3654,133452,149.67761066470712,130930,229.8,1132,542,LARGE,242,,,
339,14190,19734,134157,149.67761066470712,119967,245.6,5544,451,LARGE,267,,,
373,15390,21427,134247,149.67761066470712,118857,243.3,6037,445,LARGE,268,,,
247,10418,14449,136498,149.67761066470712,126080,242.9,4031,483,LARGE,262,,,
21,638,1053,136745,149.67761066470712,136107,208.6,415,635,LARGE,215,,,
479,19041,27018,136955,149.67761066470712,117914,235.4,7977,460,LARGE,257,,,
493,19680,27930,137076,149.67761066470712,117396,234.3,8250,455,LARGE,259,,,
404,16547,23165,137545,149.67761066470712,120998,237.0,6618,466,LARGE,260,,,
201,8532,11808,137754,149.67761066470712,129222,239.9,3276,519,LARGE,249,,,
202,8667,11955,137774,149.67761066470712,129107,240.2,3288,519,LARGE,249,,,
122,4941,6991,139062,149.67761066470712,134121,233.2,2050,546,LARGE,246,,,
19,627,1011,139720,149.67761066470712,139093,206.2,384,646,LARGE,216,,,
53,1970,2908,140861,149.67761066470712,138891,219.6,938,606,LARGE,230,,,
23,747,1164,141008,149.67761066470712,140261,206.9,417,660,LARGE,213,,,
472,18887,26728,141750,149.67761066470712,122863,228.4,7841,486,LARGE,253,,,
129,5100,7282,141969,149.67761066470712,136869,230.4,2182,568,LARGE,241,,,
146,5946,8423,142859,149.67761066470712,136913,230.2,2477,567,LARGE,242,,,
379,15581,21732,143069,149.67761066470712,127488,230.7,6151,520,LARGE,246,,,
386,15777,22052,143146,149.67761066470712,127369,229.9,6275,513,LARGE,249,,,
406,16669,23300,143257,149.67761066470712,126588,228.8,6631,505,LARGE,251,,,
306,12438,17491,143812,149.67761066470712,131374,231.6,5053,528,LARGE,249,,,
471,18860,26686,144497,149.67761066470712,125637,224.6,7826,512,LARGE,246,,,
242,10135,14120,144543,149.67761066470712,134408,231.5,3985,543,LARGE,248,,,
120,4771,6802,144584,149.67761066470712,139813,225.8,2031,599,LARGE,234,,,
271,11369,15787,145168,149.67761066470712,133799,229.5,4418,556,LARGE,241,,,
378,15569,21690,145695,149.67761066470712,130126,226.7,6121,521,LARGE,250,,,
159,6586,9217,146442,149.67761066470712,139856,226.1,2631,591,LARGE,237,,,
234,9896,13774,146748,149.67761066470712,136852,227.9,3878,571,LARGE,240,,,
435,17405,24621,146869,149.67761066470712,129464,223.0,7216,535,LARGE,242,,,
320,13114,18405,147243,149.67761066470712,134129,226.1,5291,556,LARGE,242,,,
329,13682,19079,147315,149.67761066470712,133633,226.0,5397,548,LARGE,244,,,
29,919,1476,147522,149.67761066470712,146603,204.1,557,697,LARGE,211,,,
12,416,648,147877,149.67761066470712,147461,194.6,232,738,LARGE,200,,,
125,4966,7093,147939,149.67761066470712,142973,222.9,2127,619,LARGE,231,,,
393,15938,22367,148272,149.67761066470712,132334,221.5,6429,557,LARGE,238,,,
421,17066,24006,148479,149.67761066470712,131413,220.2,6940,557,LARGE,236,,,
200,8433,11701,148515,149.67761066470712,140082,224.4,3268,594,LARGE,236,,,
204,8782,12117,148519,149.67761066470712,139737,224.7,3335,583,LARGE,240,,,
75,2789,4073,148810,149.67761066470712,146021,214.8,1284,657,LARGE,223,,,
216,9391,12940,148875,149.67761066470712,139484,223.9,3549,581,LARGE,241,,,
227,9790,13528,149070,149.67761066470712,139280,223.7,3738,585,LARGE,239,,,
333,13985,19436,149726,149.67761066470712,135741,221.5,5451,564,LARGE,241,,,
62,2394,3454,149824,149.67761066470712,147430,212.3,1060,673,LARGE,220,,,
267,11136,15493,149906,149.67761066470712,138770,221.6,4357,598,LARGE,233,,,
395,16009,22472,150576,149.67761066470712,134567,217.3,6463,578,LARGE,233,,,
189,8136,11209,150778,149.67761066470712,142642,220.7,3073,612,LARGE,234,,,
232,9863,13690,151965,149.67761066470712,142102,219.9,3827,610,LARGE,233,,,
238,10067,14006,152024,149.67761066470712,141957,219.8,3939,616,LARGE,231,,,
126,4976,7114,152358,149.67761066470712,147382,215.6,2138,658,LARGE,224,,,
169,7183,9974,152834,149.67761066470712,145651,218.1,2791,633,LARGE,231,,,
35,1305,1917,152848,149.67761066470712,151543,199.8,612,733,LARGE,207,,,
469,18823,26602,153407,149.67761066470712,134584,208.9,7779,592,LARGE,228,,,
297,12026,16918,153583,149.67761066470712,141557,215.8,4892,607,LARGE,234,,,
76,2797,4094,154502,149.67761066470712,151705,205.0,1297,715,LARGE,213,,,
398,16151,22661,154914,149.67761066470712,138763,209.5,6510,612,LARGE,227,,,
109,4219,6046,155064,149.67761066470712,150845,209.5,1827,682,LARGE,222,,,
155,6439,8996,155147,149.67761066470712,148708,210.9,2557,679,LARGE,220,,,
102,3912,5632,155498,149.67761066470712,151586,206.7,1720,714,LARGE,213,,,
52,1931,2863,155955,149.67761066470712,154024,198.3,932,755,LARGE,205,,,
73,2737,3968,156051,149.67761066470712,153314,202.3,1231,731,LARGE,210,,,
348,14577,20242,156699,149.67761066470712,142122,208.2,5665,637,LARGE,224,,,
220,9519,13129,157436,149.67761066470712,147917,208.6,3610,661,LARGE,224,,,
241,10123,14099,157571,149.67761066470712,147448,208.4,3976,668,LARGE,221,,,
269,11278,15661,157655,149.67761066470712,146377,206.4,4383,680,LARGE,216,,,
466,18674,26392,158121,149.67761066470712,139447,201.3,7718,623,LARGE,224,,,
476,18939,26854,158156,149.67761066470712,139217,200.9,7915,633,LARGE,220,,,
161,6640,9322,158859,149.67761066470712,152219,204.2,2682,709,LARGE,215,,,
235,9974,13879,159302,149.67761066470712,149328,204.8,3905,681,LARGE,220,,,
283,11768,16411,160601,149.67761066470712,148833,202.1,4643,697,LARGE,214,,,
6,253,375,160721,149.67761066470712,160468,173.9,122,894,LARGE,180,,,
239,10087,14036,160943,149.67761066470712,150856,201.1,3949,711,LARGE,213,,,
22,689,1116,161134,149.67761066470712,160445,182.4,427,841,LARGE,191,,,
143,5740,8171,162097,149.67761066470712,156357,197.7,2431,757,LARGE,207,,,
45,1716,2513,162131,149.67761066470712,160415,190.6,797,812,LARGE,198,,,
56,1998,2992,162158,149.67761066470712,160160,190.5,994,805,LARGE,199,,,
101,3857,5562,162381,149.67761066470712,158524,193.9,1705,792,LARGE,201,,,
307,12468,17533,163900,149.67761066470712,151432,193.6,5065,726,LARGE,209,,,
24,783,1227,164255,149.67761066470712,163472,177.6,444,898,LARGE,183,,,
448,17933,25293,164336,149.67761066470712,146403,187.8,7360,717,LARGE,205,,,
480,19044,27039,164515,149.67761066470712,145471,185.7,7995,710,LARGE,205,,,
72,2645,3882,165063,149.67761066470712,162418,186.8,1237,821,LARGE,198,,,
51,1921,2842,165144,149.67761066470712,163223,185.7,921,857,LARGE,191,,,
40,1404,2119,165309,149.67761066470712,163905,181.9,715,877,LARGE,187,,,
225,9773,13465,165422,149.67761066470712,155649,191.0,3692,767,LARGE,203,,,
428,17280,24363,165578,149.67761066470712,148298,185.7,7083,728,LARGE,204,,,
490,19528,27720,165836,149.67761066470712,146308,181.8,8192,725,LARGE,202,,,
315,12868,18048,165872,149.67761066470712,153004,188.5,5180,754,LARGE,203,,,
316,12907,18111,165878,149.67761066470712,152971,188.4,5204,745,LARGE,206,,,
441,17552,24852,166877,149.67761066470712,149325,181.6,7300,751,LARGE,199,,,
141,5654,8063,167627,149.67761066470712,161973,186.4,2409,834,LARGE,195,,,
414,16939,23734,167630,149.67761066470712,150691,180.8,6795,762,LARGE,198,,,
282,11745,16369,167764,149.67761066470712,156019,185.1,4624,787,LARGE,199,,,
32,1179,1749,167876,149.67761066470712,166697,173.3,570,926,LARGE,181,,,
455,18114,25629,167963,149.67761066470712,149849,177.7,7515,762,LARGE,197,,,
463,18442,26106,167996,149.67761066470712,149554,177.4,7664,771,LARGE,194,,,
483,19318,27347,168040,149.67761066470712,148722,175.8,8029,761,LARGE,196,,,
401,16389,22934,168400,149.67761066470712,152011,178.1,6545,782,LARGE,195,,,
127,5006,7156,168498,149.67761066470712,163492,182.8,2150,853,LARGE,192,,,
42,1563,2303,168609,149.67761066470712,167046,175.5,740,905,LARGE,185,,,
453,18003,25461,168702,149.67761066470712,150699,174.6,7458,788,LARGE,192,,,
218,9449,13003,168785,149.67761066470712,159336,184.6,3554,819,LARGE,195,,,
286,11796,16495,169035,149.67761066470712,157239,180.6,4699,818,LARGE,193,,,
488,19491,27615,169113,149.67761066470712,149622,172.3,8124,794,LARGE,189,,,
108,4123,5941,169148,149.67761066470712,165025,180.3,1818,873,LARGE,190,,,
135,5456,7727,169181,149.67761066470712,163725,179.9,2271,871,LARGE,188,,,
78,2896,4220,169205,149.67761066470712,166309,175.6,1324,902,LARGE,185,,,
149,6131,8675,169214,149.67761066470712,163083,181.9,2544,848,LARGE,193,,,
246,10329,14365,169317,149.67761066470712,158988,180.7,4036,838,LARGE,190,,,
273,11483,15913,169368,149.67761066470712,157885,179.2,4430,828,LARGE,191,,,
224,9719,13381,169594,149.67761066470712,159875,177.9,3662,855,LARGE,187,,,
317,12958,18174,169815,149.67761066470712,156857,178.3,5216,810,LARGE,194,,,
374,15425,21469,170018,149.67761066470712,154593,175.9,6044,813,LARGE,191,,,
460,18285,25902,170269,149.67761066470712,151984,170.9,7617,819,LARGE,186,,,
305,12372,17426,170575,149.67761066470712,158203,170.5,5054,871,LARGE,182,,,
384,15731,21984,170847,149.67761066470712,155116,172.2,6253,839,LARGE,185,,,
449,17935,25314,170982,149.67761066470712,153047,168.0,7379,828,LARGE,185,,,
233,9864,13711,171140,149.67761066470712,161276,171.2,3847,890,LARGE,182,,,
287,11804,16516,171268,149.67761066470712,159464,167.7,4712,881,LARGE,182,,,
324,13313,18664,171300,149.67761066470712,157987,171.3,5351,850,LARGE,186,,,
327,13669,19037,171330,149.67761066470712,157661,171.3,5368,848,LARGE,186,,,
340,14227,19776,171401,149.67761066470712,157174,170.3,5549,847,LARGE,186,,,
353,14692,20452,171410,149.67761066470712,156718,169.8,5760,848,LARGE,185,,,
397,16118,22598,171487,149.67761066470712,155369,168.0,6480,853,LARGE,183,,,
410,16776,23489,171501,149.67761066470712,154725,167.5,6713,853,LARGE,182,,,
277,11525,16039,171781,149.67761066470712,160256,166.3,4514,906,LARGE,177,,,
113,4493,6388,171863,149.67761066470712,167370,164.8,1895,978,LARGE,172,,,
364,15167,21038,171959,149.67761066470712,156792,166.1,5871,871,LARGE,181,,,
223,9699,13339,172224,149.67761066470712,162525,165.1,3640,932,LARGE,175,,,
337,14113,19610,172377,149.67761066470712,158264,163.7,5497,885,LARGE,179,,,
411,16828,23567,172443,149.67761066470712,155615,160.9,6739,882,LARGE,177,,,
415,16940,23755,172454,149.67761066470712,155514,160.8,6815,890,LARGE,175,,,
442,17570,24894,172483,149.67761066470712,154913,158.5,7324,887,LARGE,175,,,
451,17958,25377,172486,149.67761066470712,154528,158.1,7419,882,LARGE,176,,,
497,19952,28233,172543,149.67761066470712,152591,155.5,8281,894,LARGE,171,,,
137,5507,7832,172552,149.67761066470712,167045,161.6,2325,988,LARGE,170,,,
217,9420,12982,172565,149.67761066470712,163145,161.9,3562,952,LARGE,172,,,
284,11771,16432,172635,149.67761066470712,160864,159.3,4661,946,LARGE,171,,,
325,13388,18769,172659,149.67761066470712,159271,161.3,5381,902,LARGE,177,,,
419,17000,23880,172749,149.67761066470712,155749,157.3,6880,905,LARGE,173,,,
280,11682,16270,172843,149.67761066470712,161161,156.3,4588,969,LARGE,167,,,
285,11790,16474,172845,149.67761066470712,161055,155.3,4684,961,LARGE,168,,,
338,14162,19694,172872,149.67761066470712,158710,157.1,5532,925,LARGE,172,,,
255,10735,14897,172972,149.67761066470712,162237,154.3,4162,995,LARGE,164,,,
264,11118,15409,172990,149.67761066470712,161872,154.1,4291,997,LARGE,163,,,
383,15690,21921,173047,149.67761066470712,157357,152.4,6231,954,LARGE,165,,,
475,18935,26833,173065,149.67761066470712,154130,147.8,7898,957,LARGE,162,,,
334,14003,19457,173162,149.67761066470712,159159,148.4,5454,992,LARGE,161,,,
381,15632,21816,173183,149.67761066470712,157551,146.5,6184,1000,LARGE,158,,,
478,18999,26959,173195,149.67761066470712,154196,141.1,7960,991,LARGE,156,,,
