pids,instantiation times,start times,finish times,average wait times,turnaround times,average queue lengths,response times,required cpu times,process sizes,turnaround times,efficiency,average response time,average queue length
1,475,521,535,85.17137538229689,60,2.0,46,14,TINY,5,0.9486151354064475,1393.196,113
0,197,198,975,85.17137538229689,778,1.0,1,733,LARGE,2,,,
2,1109,1110,1122,85.17137538229689,13,1.0,1,12,TINY,2,,,
3,1157,1158,1227,85.17137538229689,70,1.0,1,66,SMALL,2,,,
4,1767,1768,2427,85.17137538229689,660,1.7,1,352,LARGE,2,,,
6,2250,2258,2737,85.17137538229689,487,3.3,8,147,SMALL,4,,,
9,2831,2842,2896,85.17137538229689,65,5.0,11,32,TINY,3,,,
15,3756,3763,3786,85.17137538229689,30,9.0,7,22,TINY,2,,,
11,2948,2991,3796,85.17137538229689,848,5.8,43,119,SMALL,8,,,
16,3807,3849,3896,85.17137538229689,89,8.0,42,45,TINY,2,,,
22,5317,5356,5392,85.17137538229689,75,13.0,39,35,TINY,3,,,
12,3196,3210,6048,85.17137538229689,2852,8.9,14,298,LARGE,10,,,
27,6099,6101,6160,85.17137538229689,61,16.3,2,57,SMALL,2,,,
20,4944,4970,6745,85.17137538229689,1801,13.0,26,111,SMALL,17,,,
21,5182,5189,7050,85.17137538229689,1868,14.1,7,153,SMALL,13,,,
33,7557,7594,7610,85.17137538229689,53,19.0,37,16,TINY,4,,,
26,5880,5894,7905,85.17137538229689,2025,16.2,14,112,SMALL,19,,,
36,8596,8624,8690,85.17137538229689,94,20.0,28,43,TINY,3,,,
34,7638,7684,8787,85.17137538229689,1149,19.0,46,103,SMALL,12,,,
38,8926,8955,8975,85.17137538229689,49,20.0,29,20,TINY,3,,,
39,9007,9028,9120,85.17137538229689,113,21.0,21,48,TINY,3,,,
29,7010,7051,10252,85.17137538229689,3242,18.8,41,175,SMALL,19,,,
30,7053,7093,10262,85.17137538229689,3209,18.9,40,169,SMALL,19,,,
7,2318,2321,10750,85.17137538229689,8432,10.6,3,684,LARGE,13,,,
44,10359,10772,10784,85.17137538229689,425,23.0,413,12,TINY,36,,,
50,11563,11614,11700,85.17137538229689,137,27.0,51,22,TINY,7,,,
49,11513,11572,11703,85.17137538229689,190,26.3,59,42,TINY,5,,,
19,4800,4834,11766,85.17137538229689,6966,17.1,34,340,LARGE,21,,,
8,2623,2636,12094,85.17137538229689,9471,12.1,13,624,LARGE,16,,,
53,12164,12199,12209,85.17137538229689,45,25.0,35,10,TINY,5,,,
57,12682,12711,12740,85.17137538229689,58,28.0,29,28,TINY,3,,,
32,7528,7552,12794,85.17137538229689,5266,20.8,24,221,LARGE,24,,,
58,13138,13159,13195,85.17137538229689,57,27.5,21,35,TINY,2,,,
59,13173,13196,13240,85.17137538229689,67,27.0,23,42,TINY,2,,,
51,11605,11677,13265,85.17137538229689,1660,25.8,72,84,SMALL,20,,,
42,9554,9569,13924,85.17137538229689,4370,23.2,15,193,SMALL,23,,,
55,12461,12481,14075,85.17137538229689,1614,26.2,20,94,SMALL,18,,,
23,5531,5549,14323,85.17137538229689,8792,19.7,18,398,LARGE,23,,,
45,10484,10911,14435,85.17137538229689,3951,24.0,427,117,SMALL,34,,,
5,1975,1987,14850,85.17137538229689,12875,11.2,12,948,LARGE,14,,,
66,15152,15174,15191,85.17137538229689,39,27.0,22,17,TINY,3,,,
67,15451,15452,15479,85.17137538229689,28,27.5,1,26,TINY,2,,,
61,13955,13977,15666,85.17137538229689,1711,26.5,22,68,SMALL,26,,,
17,4686,4729,15741,85.17137538229689,11055,18.7,43,492,LARGE,23,,,
74,16156,16212,16265,85.17137538229689,109,31.0,56,31,TINY,4,,,
47,11380,11436,16316,85.17137538229689,4936,24.9,56,189,SMALL,27,,,
77,17174,17223,17273,85.17137538229689,99,32.0,49,48,TINY,3,,,
63,14554,14592,18273,85.17137538229689,3719,27.8,38,140,SMALL,27,,,
81,18551,18586,18603,85.17137538229689,52,35.0,35,17,TINY,4,,,
83,18614,18646,18711,85.17137538229689,97,35.0,32,42,TINY,3,,,
60,13719,13734,19058,85.17137538229689,5339,28.8,15,193,SMALL,28,,,
78,17660,17690,19789,85.17137538229689,2129,33.0,30,81,SMALL,27,,,
46,10622,11079,20063,85.17137538229689,9441,27.4,457,273,LARGE,35,,,
25,5802,5831,20927,85.17137538229689,15125,23.6,29,542,LARGE,28,,,
90,20518,21264,22174,85.17137538229689,1656,46.0,746,27,TINY,62,,,
14,3455,3492,22208,85.17137538229689,18753,20.6,37,822,LARGE,23,,,
92,20630,21411,22317,85.17137538229689,1687,46.0,781,23,TINY,74,,,
96,21083,21957,22596,85.17137538229689,1513,46.5,874,25,TINY,61,,,
103,22613,22849,22867,85.17137538229689,254,47.0,236,18,TINY,15,,,
100,21815,22528,22962,85.17137538229689,1147,47.3,713,50,TINY,23,,,
107,22896,23068,23085,85.17137538229689,189,50.0,172,17,TINY,12,,,
106,22864,23026,23179,85.17137538229689,315,50.0,162,29,TINY,11,,,
109,22983,23128,23229,85.17137538229689,246,49.0,145,27,TINY,10,,,
105,22849,23005,23243,85.17137538229689,394,49.0,156,53,SMALL,8,,,
110,23169,23244,23311,85.17137538229689,142,47.0,75,44,TINY,4,,,
28,6134,6161,24185,85.17137538229689,18051,26.0,27,588,LARGE,31,,,
114,24318,24342,24443,85.17137538229689,125,50.0,24,57,SMALL,3,,,
69,15585,15595,24938,85.17137538229689,9353,37.5,10,254,LARGE,37,,,
119,25289,25324,25372,85.17137538229689,83,52.0,35,26,TINY,4,,,
97,21219,22104,25903,85.17137538229689,4684,48.5,885,90,SMALL,53,,,
121,25883,25904,25955,85.17137538229689,72,52.7,21,49,TINY,2,,,
123,25939,25977,26068,85.17137538229689,129,53.3,38,47,TINY,3,,,
126,26113,26174,26239,85.17137538229689,126,56.0,61,22,TINY,6,,,
111,23441,23468,27173,85.17137538229689,3732,52.6,27,104,SMALL,36,,,
135,27242,27289,27311,85.17137538229689,69,62.0,47,21,TINY,4,,,
137,27560,27583,27611,85.17137538229689,51,63.0,23,27,TINY,2,,,
65,14938,14955,27815,85.17137538229689,12877,39.3,17,305,LARGE,43,,,
10,2836,2863,27961,85.17137538229689,25125,22.4,27,970,LARGE,26,,,
139,28142,28170,28200,85.17137538229689,58,62.0,28,29,TINY,2,,,
140,28313,28357,28406,85.17137538229689,93,62.0,44,47,TINY,2,,,
13,3366,3377,28477,85.17137538229689,25111,23.0,11,898,LARGE,28,,,
18,4731,4771,28830,85.17137538229689,24099,26.5,40,759,LARGE,32,,,
79,17735,17753,28983,85.17137538229689,11248,43.3,18,267,LARGE,43,,,
118,25284,25303,29118,85.17137538229689,3834,53.5,19,90,SMALL,43,,,
88,20171,20904,29295,85.17137538229689,9124,48.8,733,119,SMALL,77,,,
91,20567,21327,29474,85.17137538229689,8907,50.0,760,121,SMALL,74,,,
133,26998,27013,30289,85.17137538229689,3291,60.8,15,80,SMALL,42,,,
108,22923,23086,31432,85.17137538229689,8509,54.7,163,138,SMALL,62,,,
48,11511,11551,31612,85.17137538229689,20101,38.1,40,451,LARGE,45,,,
37,8801,8840,31631,85.17137538229689,22830,34.2,39,568,LARGE,41,,,
113,23762,23802,31679,85.17137538229689,7917,55.7,40,135,SMALL,59,,,
40,9020,9049,32987,85.17137538229689,23967,36.0,29,575,LARGE,42,,,
89,20397,21117,33573,85.17137538229689,13176,54.8,720,218,LARGE,61,,,
122,25925,25956,33770,85.17137538229689,7845,59.2,31,157,SMALL,50,,,
155,32438,33771,33785,85.17137538229689,1347,68.0,1333,14,TINY,97,,,
151,31900,33156,34021,85.17137538229689,2121,67.5,1256,24,TINY,89,,,
161,33760,34148,34401,85.17137538229689,641,68.0,388,21,TINY,31,,,
164,34273,34507,34592,85.17137538229689,319,68.0,234,21,TINY,16,,,
163,34233,34465,34616,85.17137538229689,383,67.7,232,42,TINY,10,,,
72,16037,16076,34994,85.17137538229689,18957,45.7,39,333,LARGE,57,,,
80,18091,18128,35153,85.17137538229689,17062,49.1,37,282,LARGE,61,,,
168,35631,35655,35705,85.17137538229689,74,68.0,24,48,TINY,2,,,
169,35764,35810,35841,85.17137538229689,77,68.0,46,30,TINY,3,,,
54,12215,12262,36301,85.17137538229689,24086,42.8,47,511,LARGE,48,,,
171,36489,36510,36565,85.17137538229689,76,69.5,21,33,TINY,3,,,
174,36577,36629,36716,85.17137538229689,139,70.0,52,43,TINY,4,,,
62,14227,14232,36923,85.17137538229689,22696,45.1,5,468,LARGE,49,,,
144,29513,29527,37505,85.17137538229689,7992,63.8,14,169,SMALL,48,,,
145,29568,29590,37517,85.17137538229689,7949,63.0,22,131,SMALL,61,,,
153,32298,33595,38209,85.17137538229689,5911,68.0,1297,64,SMALL,93,,,
99,21703,22465,38963,85.17137538229689,17260,58.8,762,242,LARGE,72,,,
129,26433,26449,38967,85.17137538229689,12534,62.6,16,173,SMALL,73,,,
24,5535,5570,39466,85.17137538229689,33931,35.1,35,799,LARGE,43,,,
165,35318,35362,39773,85.17137538229689,4455,68.0,44,73,SMALL,62,,,
166,35368,35404,39786,85.17137538229689,4418,68.5,36,72,SMALL,62,,,
84,19071,19111,40168,85.17137538229689,21097,53.0,40,346,LARGE,61,,,
70,15806,15846,40412,85.17137538229689,24606,48.5,40,442,LARGE,56,,,
143,29305,29348,40524,85.17137538229689,11219,64.2,43,176,SMALL,64,,,
138,27644,27664,41485,85.17137538229689,13841,66.4,20,235,LARGE,59,,,
56,12503,12544,41870,85.17137538229689,29367,46.0,41,556,LARGE,53,,,
87,20014,20757,41937,85.17137538229689,21923,58.8,743,293,LARGE,75,,,
190,41386,42862,42882,85.17137538229689,1496,73.0,1476,20,TINY,75,,,
35,8535,8582,43367,85.17137538229689,34832,41.2,47,731,LARGE,48,,,
146,30468,31680,43636,85.17137538229689,13168,68.6,1212,166,SMALL,80,,,
182,38546,38566,43901,85.17137538229689,5355,73.2,20,112,SMALL,48,,,
134,27163,27174,44197,85.17137538229689,17034,66.5,11,261,LARGE,66,,,
195,43174,44471,44481,85.17137538229689,1307,79.0,1297,10,TINY,131,,,
193,42836,44282,44740,85.17137538229689,1904,78.5,1446,26,TINY,74,,,
201,43981,44629,45154,85.17137538229689,1173,78.7,648,54,SMALL,22,,,
207,45094,45260,45273,85.17137538229689,179,79.0,166,13,TINY,14,,,
206,45001,45218,45291,85.17137538229689,290,78.5,217,37,TINY,8,,,
209,45483,45511,45559,85.17137538229689,76,79.0,28,26,TINY,3,,,
85,19106,19132,45915,85.17137538229689,26809,56.6,26,411,LARGE,66,,,
213,46099,46135,46158,85.17137538229689,59,81.0,36,22,TINY,3,,,
95,21077,21936,46989,85.17137538229689,25912,62.0,859,347,LARGE,75,,,
152,31977,33261,47530,85.17137538229689,15553,71.2,1284,179,SMALL,87,,,
221,48115,48146,48254,85.17137538229689,139,87.0,31,43,TINY,4,,,
224,48444,48464,48505,85.17137538229689,61,88.0,20,40,TINY,2,,,
228,49041,49059,49094,85.17137538229689,53,91.0,18,34,TINY,2,,,
189,41337,42778,49983,85.17137538229689,8646,80.2,1441,72,SMALL,121,,,
202,44036,44650,50189,85.17137538229689,6153,82.2,614,66,SMALL,94,,,
117,24798,24840,50630,85.17137538229689,25832,67.5,42,350,LARGE,74,,,
178,38266,38314,51152,85.17137538229689,12886,76.6,48,187,SMALL,69,,,
64,14654,14655,51676,85.17137538229689,37022,55.5,1,609,LARGE,61,,,
41,9194,9246,52220,85.17137538229689,43026,46.8,52,788,LARGE,55,,,
215,46700,46742,52785,85.17137538229689,6085,88.6,42,98,SMALL,63,,,
101,21975,22597,53481,85.17137538229689,31506,69.3,622,402,LARGE,79,,,
240,51520,53524,53540,85.17137538229689,2020,103.0,2004,16,TINY,127,,,
31,7066,7114,54326,85.17137538229689,47260,45.4,48,898,LARGE,53,,,
238,51228,53206,55275,85.17137538229689,4047,106.5,1978,23,TINY,176,,,
236,50646,52599,56273,85.17137538229689,5627,108.0,1953,50,TINY,113,,,
261,55406,56505,56522,85.17137538229689,1116,122.0,1099,17,TINY,66,,,
241,51564,53583,56638,85.17137538229689,5074,112.7,2019,50,TINY,102,,,
251,53908,56032,56698,85.17137538229689,2790,118.0,2124,37,TINY,76,,,
254,54585,56242,56870,85.17137538229689,2285,119.5,1657,23,TINY,100,,,
256,54650,56295,56949,85.17137538229689,2299,120.0,1645,35,TINY,66,,,
245,52811,54852,57064,85.17137538229689,4253,117.0,2041,49,TINY,87,,,
260,55230,56463,57124,85.17137538229689,1894,120.0,1233,37,TINY,52,,,
272,56443,57086,57606,85.17137538229689,1163,117.5,643,39,TINY,30,,,
278,57891,57985,58075,85.17137538229689,184,120.0,94,26,TINY,8,,,
279,58342,58378,58439,85.17137538229689,97,121.0,36,39,TINY,3,,,
280,58367,58399,58462,85.17137538229689,95,120.7,32,41,TINY,3,,,
283,59030,59057,59085,85.17137538229689,55,122.0,27,27,TINY,3,,,
284,59288,59294,59325,85.17137538229689,37,122.0,6,30,TINY,2,,,
285,59366,59378,59417,85.17137538229689,51,122.5,12,38,TINY,2,,,
223,48241,48276,60755,85.17137538229689,12514,99.9,35,137,SMALL,92,,,
235,50469,52431,61357,85.17137538229689,10888,113.8,1962,73,SMALL,150,,,
277,57853,57943,62001,85.17137538229689,4148,123.2,90,73,SMALL,57,,,
52,11968,11975,62285,85.17137538229689,50317,58.8,7,750,LARGE,68,,,
292,60344,62979,62996,85.17137538229689,2652,134.0,2635,17,TINY,156,,,
295,60777,63459,63475,85.17137538229689,2698,135.0,2682,16,TINY,169,,,
186,39655,39697,63813,85.17137538229689,24158,93.0,42,251,LARGE,97,,,
229,49429,49459,63834,85.17137538229689,14405,107.4,30,160,SMALL,91,,,
244,52773,54789,64144,85.17137538229689,11371,122.8,2016,95,SMALL,120,,,
257,54683,56337,64337,85.17137538229689,9654,124.2,1654,83,SMALL,117,,,
266,56067,56720,64505,85.17137538229689,8438,124.2,653,100,SMALL,85,,,
196,43264,44503,64807,85.17137538229689,21543,103.6,1239,197,SMALL,110,,,
175,36721,36769,65434,85.17137538229689,28713,92.1,48,287,LARGE,101,,,
293,60450,63102,65844,85.17137538229689,5394,138.0,2652,30,TINY,180,,,
220,48112,48125,66130,85.17137538229689,18018,108.4,13,172,SMALL,105,,,
104,22809,22963,66359,85.17137538229689,43550,80.3,154,498,LARGE,88,,,
297,60926,63644,66401,85.17137538229689,5475,139.0,2718,40,TINY,137,,,
184,39486,39519,66492,85.17137538229689,27006,95.9,33,276,LARGE,98,,,
112,23716,23739,66506,85.17137538229689,42790,80.7,23,493,LARGE,87,,,
249,53509,55612,66895,85.17137538229689,13386,126.7,2103,110,SMALL,122,,,
252,54199,56158,66950,85.17137538229689,12751,127.2,1959,112,SMALL,114,,,
311,64952,67686,67696,85.17137538229689,2744,146.0,2734,10,TINY,275,,,
313,65266,68033,68052,85.17137538229689,2786,146.0,2767,19,TINY,147,,,
316,65505,68221,68976,85.17137538229689,3471,147.5,2716,40,TINY,87,,,
325,66456,68515,69236,85.17137538229689,2780,147.5,2059,27,TINY,103,,,
306,64230,66917,69306,85.17137538229689,5076,146.3,2687,46,TINY,111,,,
312,64965,67718,69526,85.17137538229689,4561,147.3,2753,49,TINY,94,,,
337,68899,69548,69565,85.17137538229689,666,147.0,649,17,TINY,40,,,
333,68407,69124,69715,85.17137538229689,1308,148.0,717,22,TINY,60,,,
335,68815,69454,69954,85.17137538229689,1139,148.0,639,27,TINY,43,,,
332,67712,68851,69965,85.17137538229689,2253,147.7,1139,50,TINY,46,,,
226,48611,48621,70907,85.17137538229689,22296,113.8,10,197,SMALL,114,,,
102,22181,22660,70916,85.17137538229689,48735,82.8,479,508,LARGE,96,,,
82,18557,18604,71179,85.17137538229689,52622,75.9,47,620,LARGE,85,,,
246,52871,54936,71353,85.17137538229689,18482,129.9,2065,125,SMALL,148,,,
248,53432,55507,71394,85.17137538229689,17962,129.9,2075,139,SMALL,130,,,
268,56179,56825,71609,85.17137538229689,15430,130.9,646,124,SMALL,125,,,
210,45573,45612,72065,85.17137538229689,26492,112.0,39,244,LARGE,109,,,
68,15453,15480,72271,85.17137538229689,56818,72.2,27,726,LARGE,79,,,
296,60925,63623,72405,85.17137538229689,11480,144.5,2698,67,SMALL,172,,,
120,25584,25602,73218,85.17137538229689,47634,86.4,18,484,LARGE,99,,,
180,38408,38440,73721,85.17137538229689,35313,101.2,32,329,LARGE,108,,,
128,26301,26334,73870,85.17137538229689,47569,89.2,33,471,LARGE,101,,,
255,54643,56274,74460,85.17137538229689,19817,133.6,1631,141,SMALL,141,,,
276,57771,57901,74798,85.17137538229689,17027,135.0,130,141,SMALL,121,,,
191,41769,43240,74808,85.17137538229689,33039,114.4,1471,249,LARGE,133,,,
331,67433,68788,76077,85.17137538229689,8644,150.8,1355,88,SMALL,99,,,
98,21353,22251,76504,85.17137538229689,55151,86.8,898,546,LARGE,102,,,
345,70550,73555,76604,85.17137538229689,6054,155.5,3005,35,TINY,173,,,
349,71112,74165,77266,85.17137538229689,6154,158.0,3053,30,TINY,206,,,
247,53346,55402,77516,85.17137538229689,24170,136.1,2056,178,SMALL,136,,,
262,55452,56544,77662,85.17137538229689,22210,136.8,1092,179,SMALL,125,,,
354,72042,75103,78248,85.17137538229689,6206,158.5,3061,38,TINY,164,,,
328,66661,68578,79203,85.17137538229689,12542,153.5,1917,109,SMALL,116,,,
344,70406,73387,79360,85.17137538229689,8954,159.7,2981,49,TINY,183,,,
359,73777,76794,79385,85.17137538229689,5608,162.5,3017,23,TINY,244,,,
374,77219,79554,79573,85.17137538229689,2354,166.0,2335,19,TINY,124,,,
364,74453,77559,79625,85.17137538229689,5172,162.5,3106,29,TINY,179,,,
352,71507,74566,79670,85.17137538229689,8163,160.0,3059,42,TINY,195,,,
357,72334,75418,79939,85.17137538229689,7605,162.0,3084,56,SMALL,136,,,
370,76262,79288,80078,85.17137538229689,3816,165.0,3026,32,TINY,120,,,
183,39189,39228,81452,85.17137538229689,42263,109.6,39,358,LARGE,119,,,
234,50277,52221,81687,85.17137538229689,31410,137.1,1944,183,SMALL,172,,,
264,55864,56660,81881,85.17137538229689,26017,140.4,796,184,SMALL,142,,,
265,56064,56699,81894,85.17137538229689,25830,140.3,635,192,SMALL,135,,,
204,44278,44713,82211,85.17137538229689,37933,121.8,435,291,LARGE,131,,,
76,17064,17108,82315,85.17137538229689,65251,82.3,44,739,LARGE,89,,,
351,71502,74545,83288,85.17137538229689,11786,164.8,3043,66,SMALL,179,,,
375,77457,79595,83548,85.17137538229689,6091,169.3,2138,47,TINY,130,,,
377,77973,79713,83659,85.17137538229689,5686,169.7,1740,45,TINY,127,,,
381,78453,79902,83732,85.17137538229689,5279,169.3,1449,49,TINY,108,,,
214,46426,46471,84034,85.17137538229689,37608,124.9,45,267,LARGE,141,,,
43,10185,10620,84046,85.17137538229689,73861,71.3,435,901,LARGE,82,,,
150,31674,32919,84388,85.17137538229689,52714,107.0,1245,425,LARGE,125,,,
198,43779,44566,85424,85.17137538229689,41645,125.4,787,316,LARGE,132,,,
400,82139,85425,85436,85.17137538229689,3297,182.0,3286,11,TINY,300,,,
287,59497,59533,85746,85.17137538229689,26249,146.5,36,215,LARGE,123,,,
212,45955,45968,85769,85.17137538229689,39814,126.8,13,311,LARGE,129,,,
300,61866,64590,85970,85.17137538229689,24104,156.2,2724,151,SMALL,160,,,
304,63118,65845,86053,85.17137538229689,22935,157.8,2727,159,SMALL,145,,,
308,64393,67098,86153,85.17137538229689,21760,158.4,2705,155,SMALL,141,,,
329,66966,68620,86519,85.17137538229689,19553,159.2,1654,148,SMALL,133,,,
342,70291,73240,86547,85.17137538229689,16256,166.4,2949,86,SMALL,190,,,
71,15848,15888,87139,85.17137538229689,71291,82.1,40,763,LARGE,94,,,
230,49459,49501,87997,85.17137538229689,38538,133.1,42,297,LARGE,130,,,
417,84857,88082,88094,85.17137538229689,3237,179.0,3225,12,TINY,270,,,
237,50665,52641,88265,85.17137538229689,37600,144.6,1976,222,LARGE,170,,,
197,43663,44545,88674,85.17137538229689,45011,128.4,882,339,LARGE,133,,,
200,43862,44608,88745,85.17137538229689,44883,128.5,746,337,LARGE,134,,,
299,61640,64338,89182,85.17137538229689,27542,158.8,2698,176,SMALL,157,,,
309,64602,67308,89361,85.17137538229689,24759,160.8,2706,170,SMALL,146,,,
356,72186,75271,89944,85.17137538229689,17758,170.3,3085,115,SMALL,155,,,
391,80281,83549,89997,85.17137538229689,9716,178.7,3268,50,TINY,195,,,
421,85031,88308,90476,85.17137538229689,5445,181.0,3277,36,TINY,152,,,
405,82737,86075,90711,85.17137538229689,7974,181.0,3338,43,TINY,186,,,
358,72997,76099,90957,85.17137538229689,17960,168.2,3102,74,SMALL,243,,,
382,78638,79940,91295,85.17137538229689,12657,173.0,1302,61,SMALL,208,,,
384,78925,79982,91318,85.17137538229689,12393,172.8,1057,61,SMALL,204,,,
157,32776,33891,91974,85.17137538229689,59198,114.0,1115,464,LARGE,128,,,
162,34048,34316,92070,85.17137538229689,58022,114.7,268,471,LARGE,124,,,
167,35384,35446,92270,85.17137538229689,56886,115.9,62,470,LARGE,122,,,
187,40204,41654,92304,85.17137538229689,52100,129.1,1450,362,LARGE,144,,,
75,16894,16941,92829,85.17137538229689,75935,90.2,47,800,LARGE,95,,,
323,66352,68452,93438,85.17137538229689,27086,164.3,2100,200,SMALL,136,,,
347,71010,74018,93584,85.17137538229689,22574,172.4,3008,139,SMALL,163,,,
428,87912,90292,93953,85.17137538229689,6041,188.5,2380,31,TINY,195,,,
438,89751,90859,94372,85.17137538229689,4621,189.0,1108,39,TINY,119,,,
373,77054,79449,94687,85.17137538229689,17633,178.2,2395,100,SMALL,177,,,
341,69841,70050,95060,85.17137538229689,25219,170.4,209,155,SMALL,163,,,
450,91551,95103,95113,85.17137538229689,3562,197.0,3552,10,TINY,357,,,
93,20922,21726,95146,85.17137538229689,74224,101.2,804,651,LARGE,115,,,
124,26043,26069,95214,85.17137538229689,69171,105.8,26,594,LARGE,117,,,
131,26838,26887,95693,85.17137538229689,68855,108.3,49,606,LARGE,114,,,
271,56411,57034,96136,85.17137538229689,39725,153.9,623,261,LARGE,153,,,
455,92616,96158,96173,85.17137538229689,3557,201.0,3542,15,TINY,238,,,
192,42038,43494,96219,85.17137538229689,54181,134.9,1456,373,LARGE,146,,,
86,19310,19341,96500,85.17137538229689,77190,97.4,31,757,LARGE,102,,,
425,87021,90061,97364,85.17137538229689,10343,193.0,3040,42,TINY,247,,,
427,87865,90271,97412,85.17137538229689,9547,193.0,2406,45,TINY,213,,,
435,89294,90712,97643,85.17137538229689,8349,194.0,1418,60,SMALL,140,,,
436,89433,90754,97656,85.17137538229689,8223,193.7,1321,52,SMALL,159,,,
446,91121,94583,97961,85.17137538229689,6840,199.5,3462,30,TINY,228,,,
388,79671,80331,98283,85.17137538229689,18612,184.5,660,106,SMALL,176,,,
172,36508,36531,98468,85.17137538229689,61960,123.2,23,456,LARGE,136,,,
480,96241,99792,99802,85.17137538229689,3561,209.0,3551,10,TINY,357,,,
489,97869,101231,101243,85.17137538229689,3374,210.0,3362,12,TINY,282,,,
470,95074,98469,101505,85.17137538229689,6431,207.5,3395,29,TINY,222,,,
473,95404,98847,101619,85.17137538229689,6215,208.5,3443,28,TINY,222,,,
474,95444,98889,101654,85.17137538229689,6210,208.0,3445,33,TINY,189,,,
476,95504,98994,101690,85.17137538229689,6186,207.5,3490,34,TINY,182,,,
477,95706,99204,101701,85.17137538229689,5995,207.0,3498,30,TINY,200,,,
338,69258,69821,103137,85.17137538229689,33879,175.9,563,187,SMALL,182,,,
73,16146,16191,103708,85.17137538229689,87562,96.5,45,843,LARGE,104,,,
469,94911,98305,104777,85.17137538229689,9866,205.0,3394,58,SMALL,171,,,
471,95235,98616,104867,85.17137538229689,9632,205.3,3381,45,TINY,215,,,
395,80806,84047,105105,85.17137538229689,24299,187.6,3241,86,SMALL,283,,,
409,83236,86611,105339,85.17137538229689,22103,189.4,3375,82,SMALL,270,,,
431,88843,90540,105695,85.17137538229689,16852,196.4,1697,99,SMALL,171,,,
176,37384,37392,106352,85.17137538229689,68968,130.8,8,495,LARGE,140,,,
149,31525,32793,106506,85.17137538229689,74981,126.3,1268,546,LARGE,138,,,
483,96553,100139,107434,85.17137538229689,10881,202.3,3586,43,TINY,254,,,
486,97516,101063,107481,85.17137538229689,9965,202.0,3547,44,TINY,227,,,
499,99955,101891,107718,85.17137538229689,7763,199.0,1936,45,TINY,173,,,
397,80933,84215,107783,85.17137538229689,26850,188.3,3282,101,SMALL,266,,,
411,84201,87308,108000,85.17137538229689,23799,190.8,3107,106,SMALL,225,,,
412,84302,87434,108007,85.17137538229689,23705,191.0,3132,106,SMALL,224,,,
422,85966,89183,108169,85.17137538229689,22203,191.5,3217,114,SMALL,195,,,
368,75981,79152,108542,85.17137538229689,32561,186.9,3171,175,SMALL,187,,,
369,76171,79267,108545,85.17137538229689,32374,186.8,3096,162,SMALL,200,,,
216,46752,46784,108889,85.17137538229689,62137,148.1,32,407,LARGE,153,,,
269,56263,56871,109655,85.17137538229689,53392,163.5,608,349,LARGE,153,,,
273,56627,57230,109687,85.17137538229689,53060,163.4,603,350,LARGE,152,,,
458,93180,96732,111086,85.17137538229689,17906,199.5,3552,73,SMALL,246,,,
468,94790,98172,111284,85.17137538229689,16494,199.5,3382,68,SMALL,243,,,
406,82876,86217,111880,85.17137538229689,29004,188.0,3341,127,SMALL,229,,,
416,84816,88019,112020,85.17137538229689,27204,189.4,3203,133,SMALL,205,,,
365,74630,77768,112395,85.17137538229689,37765,184.2,3138,197,SMALL,192,,,
372,77050,79428,112470,85.17137538229689,35420,186.0,2378,191,SMALL,186,,,
127,26128,26195,112838,85.17137538229689,86710,118.9,67,700,LARGE,124,,,
222,48148,48209,113089,85.17137538229689,64941,150.9,61,439,LARGE,148,,,
188,40228,41696,113288,85.17137538229689,73060,145.6,1468,479,LARGE,153,,,
289,59729,59763,113812,85.17137538229689,54083,161.9,34,339,LARGE,160,,,
453,92302,95820,114738,85.17137538229689,22436,193.8,3518,81,SMALL,277,,,
457,92756,96325,114790,85.17137538229689,22034,193.4,3569,89,SMALL,248,,,
466,94586,97962,114951,85.17137538229689,20365,193.6,3376,93,SMALL,219,,,
498,99946,101870,115360,85.17137538229689,15414,189.6,1924,89,SMALL,174,,,
130,26611,26616,116737,85.17137538229689,90126,121.8,5,721,LARGE,126,,,
185,39620,39634,116784,85.17137538229689,77164,137.9,14,554,LARGE,140,,,
318,65654,68263,117673,85.17137538229689,52019,171.8,2609,286,LARGE,182,,,
346,70988,73976,117881,85.17137538229689,46893,178.3,2988,238,LARGE,198,,,
448,91446,94961,118194,85.17137538229689,26748,188.8,3515,118,SMALL,227,,,
487,97549,101084,118641,85.17137538229689,21092,186.7,3535,105,SMALL,201,,,
420,84924,88200,119190,85.17137538229689,34266,184.2,3276,162,SMALL,212,,,
360,73784,76815,119411,85.17137538229689,45627,180.6,3031,230,LARGE,199,,,
253,54425,56200,120394,85.17137538229689,65969,163.9,1775,416,LARGE,159,,,
194,42962,44408,120551,85.17137538229689,77589,148.3,1446,519,LARGE,150,,,
350,71495,74503,121319,85.17137538229689,49824,177.1,3008,251,LARGE,199,,,
478,96044,99561,121895,85.17137538229689,25851,183.7,3517,128,SMALL,202,,,
496,98690,101548,122157,85.17137538229689,23467,181.7,2858,129,SMALL,182,,,
408,83055,86448,122400,85.17137538229689,39345,180.4,3393,191,SMALL,206,,,
418,84869,88095,122505,85.17137538229689,37636,181.2,3226,200,SMALL,189,,,
429,88123,90397,122593,85.17137538229689,34470,183.3,2274,183,SMALL,189,,,
439,89945,90922,122703,85.17137538229689,32758,183.2,977,184,SMALL,179,,,
386,79371,80121,122969,85.17137538229689,43598,180.7,750,253,LARGE,173,,,
303,62983,65708,123521,85.17137538229689,60538,169.3,2725,325,LARGE,187,,,
488,97603,101126,124531,85.17137538229689,26928,178.2,3523,141,SMALL,191,,,
326,66462,68536,126198,85.17137538229689,59736,168.7,2074,347,LARGE,173,,,
441,90000,93753,126414,85.17137538229689,36414,175.8,3753,165,SMALL,221,,,
465,94419,97783,126759,85.17137538229689,32340,176.3,3364,168,SMALL,193,,,
481,96338,99887,126848,85.17137538229689,30510,175.6,3549,164,SMALL,187,,,
497,98703,101569,127057,85.17137538229689,28354,173.9,2866,179,SMALL,159,,,
404,82736,86054,127242,85.17137538229689,44506,174.9,3318,236,LARGE,189,,,
263,55610,56586,129128,85.17137538229689,73518,163.1,976,435,LARGE,170,,,
482,96540,100097,131017,85.17137538229689,34477,171.6,3557,197,SMALL,176,,,
426,87406,90187,131539,85.17137538229689,44133,174.2,2781,257,LARGE,172,,,
376,77747,79671,131772,85.17137538229689,54025,173.2,1924,301,LARGE,180,,,
383,78760,79961,131838,85.17137538229689,53078,173.0,1201,302,LARGE,176,,,
336,68892,69527,131905,85.17137538229689,63013,169.5,635,363,LARGE,174,,,
173,36511,36566,131951,85.17137538229689,95440,137.3,55,653,LARGE,147,,,
156,32544,33870,132137,85.17137538229689,99593,133.7,1326,717,LARGE,139,,,
275,57681,57880,132622,85.17137538229689,74941,161.2,199,471,LARGE,160,,,
461,93856,97386,133730,85.17137538229689,39874,169.4,3530,215,LARGE,186,,,
393,80611,83838,134050,85.17137538229689,53439,169.1,3227,264,LARGE,203,,,
414,84524,87686,134279,85.17137538229689,49755,169.8,3162,278,LARGE,179,,,
371,76756,79361,134575,85.17137538229689,57819,170.7,2605,321,LARGE,181,,,
233,50106,52034,135197,85.17137538229689,85091,158.4,1928,502,LARGE,170,,,
116,24774,24777,135651,85.17137538229689,110877,120.9,3,882,LARGE,126,,,
320,65895,68347,135928,85.17137538229689,70033,163.7,2452,403,LARGE,174,,,
451,91904,95425,136344,85.17137538229689,44440,165.9,3521,236,LARGE,189,,,
475,95454,98931,136570,85.17137538229689,41116,165.4,3477,235,LARGE,175,,,
423,86462,89656,137021,85.17137538229689,50559,166.7,3194,289,LARGE,175,,,
154,32375,33700,137577,85.17137538229689,105202,133.3,1325,749,LARGE,141,,,
218,47632,47635,137588,85.17137538229689,89956,148.7,3,590,LARGE,153,,,
205,44775,45014,138127,85.17137538229689,93352,146.4,239,633,LARGE,148,,,
298,61623,64313,138453,85.17137538229689,76830,160.9,2690,442,LARGE,174,,,
322,66137,68410,139019,85.17137538229689,72882,160.0,2273,464,LARGE,158,,,
179,38349,38377,141177,85.17137538229689,102828,136.3,28,714,LARGE,145,,,
243,52125,54171,141457,85.17137538229689,89332,156.4,2046,536,LARGE,167,,,
274,56929,57482,141579,85.17137538229689,84650,156.8,553,546,LARGE,156,,,
170,36120,36154,141736,85.17137538229689,105616,133.0,34,749,LARGE,142,,,
390,80174,83499,142247,85.17137538229689,62073,159.7,3325,356,LARGE,175,,,
394,80648,83901,142823,85.17137538229689,62175,160.4,3253,328,LARGE,190,,,
424,86896,90019,143062,85.17137538229689,56166,161.9,3123,327,LARGE,172,,,
334,68667,69328,143387,85.17137538229689,74720,161.1,661,449,LARGE,167,,,
125,26065,26090,143480,85.17137538229689,117415,123.4,25,898,LARGE,131,,,
160,33754,34127,143665,85.17137538229689,109911,132.5,373,786,LARGE,140,,,
115,24327,24363,144058,85.17137538229689,119731,122.2,36,944,LARGE,127,,,
324,66409,68494,144419,85.17137538229689,78010,156.0,2085,493,LARGE,159,,,
132,26862,26908,145990,85.17137538229689,119128,123.8,46,916,LARGE,131,,,
291,59999,62643,146421,85.17137538229689,86422,153.1,2644,520,LARGE,167,,,
355,72084,75145,146762,85.17137538229689,74678,155.2,3061,454,LARGE,165,,,
447,91347,94835,146911,85.17137538229689,55564,150.1,3488,331,LARGE,168,,,
456,92753,96304,147026,85.17137538229689,54273,149.1,3551,350,LARGE,156,,,
459,93472,97026,147067,85.17137538229689,53595,149.0,3554,339,LARGE,159,,,
379,78274,79797,149017,85.17137538229689,70743,157.5,1523,445,LARGE,159,,,
339,69681,69987,149189,85.17137538229689,79508,156.8,306,495,LARGE,161,,,
94,21076,21915,149305,85.17137538229689,128229,119.0,839,991,LARGE,130,,,
147,30831,32058,149372,85.17137538229689,118541,130.7,1227,834,LARGE,143,,,
158,32843,33933,149628,85.17137538229689,116785,129.9,1090,856,LARGE,137,,,
159,32844,33954,149655,85.17137538229689,116811,130.7,1110,836,LARGE,140,,,
307,64344,67035,150433,85.17137538229689,86089,151.9,2691,544,LARGE,159,,,
142,29212,29223,151737,85.17137538229689,122525,124.2,11,931,LARGE,132,,,
231,49474,49522,151896,85.17137538229689,102422,141.9,48,711,LARGE,145,,,
136,27482,27520,151926,85.17137538229689,124444,122.5,38,978,LARGE,128,,,
267,56120,56762,152045,85.17137538229689,95925,149.5,642,623,LARGE,154,,,
286,59380,59418,152212,85.17137538229689,92832,146.5,38,619,LARGE,150,,,
399,81803,85103,153171,85.17137538229689,71368,146.5,3300,443,LARGE,162,,,
434,88998,90624,153413,85.17137538229689,64415,147.4,1626,440,LARGE,147,,,
366,75144,78270,153503,85.17137538229689,78359,149.3,3126,495,LARGE,159,,,
148,30958,32205,153687,85.17137538229689,122729,128.2,1247,905,LARGE,136,,,
181,38412,38461,153720,85.17137538229689,115308,131.0,49,841,LARGE,138,,,
259,54708,56379,153870,85.17137538229689,99162,147.4,1671,632,LARGE,157,,,
141,28578,28582,154044,85.17137538229689,125466,121.4,4,965,LARGE,131,,,
389,80114,83436,154386,85.17137538229689,74272,145.6,3322,455,LARGE,164,,,
452,92206,95736,154546,85.17137538229689,62340,140.8,3530,402,LARGE,156,,,
413,84465,87602,155046,85.17137538229689,70581,143.7,3137,466,LARGE,152,,,
211,45730,45779,155994,85.17137538229689,110264,135.9,49,807,LARGE,137,,,
294,60691,63354,156109,85.17137538229689,95418,144.4,2663,600,LARGE,160,,,
301,62037,64758,156138,85.17137538229689,94101,144.4,2721,618,LARGE,153,,,
319,65810,68305,156496,85.17137538229689,90686,142.7,2495,634,LARGE,144,,,
419,84881,88137,158463,85.17137538229689,73582,138.1,3256,511,LARGE,144,,,
340,69786,70008,159093,85.17137538229689,89307,145.5,222,595,LARGE,151,,,
242,52048,54066,159496,85.17137538229689,107448,139.5,2018,737,LARGE,146,,,
199,43802,44587,159743,85.17137538229689,115941,132.5,785,847,LARGE,137,,,
288,59563,59596,159943,85.17137538229689,100380,137.2,33,742,LARGE,136,,,
378,78121,79755,161099,85.17137538229689,82978,139.4,1634,581,LARGE,143,,,
177,37901,37934,161193,85.17137538229689,123292,126.1,33,939,LARGE,132,,,
353,71805,74851,161697,85.17137538229689,89892,137.3,3046,620,LARGE,145,,,
443,90642,94206,161763,85.17137538229689,71121,129.2,3564,482,LARGE,148,,,
361,74003,77067,162418,85.17137538229689,88415,136.5,3064,603,LARGE,147,,,
363,74244,77330,162452,85.17137538229689,88208,136.4,3086,612,LARGE,145,,,
270,56289,56913,162719,85.17137538229689,106430,135.4,624,784,LARGE,136,,,
463,93987,97434,163230,85.17137538229689,69243,125.6,3447,506,LARGE,137,,,
494,98400,101475,163445,85.17137538229689,65045,124.8,3075,504,LARGE,130,,,
433,88900,90603,163697,85.17137538229689,74797,130.9,1703,580,LARGE,129,,,
225,48521,48558,163886,85.17137538229689,115365,129.7,37,870,LARGE,133,,,
203,44250,44692,164021,85.17137538229689,119771,127.7,442,908,LARGE,132,,,
348,71094,74123,164612,85.17137538229689,93518,132.6,3029,647,LARGE,145,,,
449,91454,94982,164909,85.17137538229689,73455,121.4,3528,555,LARGE,133,,,
430,88567,90498,166068,85.17137538229689,77501,128.3,1931,594,LARGE,131,,,
432,88856,90561,166108,85.17137538229689,77252,125.8,1705,618,LARGE,126,,,
367,75228,78375,166251,85.17137538229689,91023,129.2,3147,677,LARGE,135,,,
227,48803,48840,166559,85.17137538229689,117756,126.3,37,916,LARGE,129,,,
239,51378,53374,166617,85.17137538229689,115239,131.5,1996,815,LARGE,142,,,
208,45460,45469,166862,85.17137538229689,121402,124.5,9,955,LARGE,128,,,
493,98346,101412,168324,85.17137538229689,69978,117.2,3066,575,LARGE,122,,,
437,89689,90838,168842,85.17137538229689,79153,120.9,1149,678,LARGE,117,,,
362,74066,77151,168860,85.17137538229689,94794,126.7,3085,707,LARGE,135,,,
380,78325,79839,168891,85.17137538229689,90566,126.9,1514,720,LARGE,126,,,
385,79340,80079,168903,85.17137538229689,89563,127.1,739,701,LARGE,128,,,
217,47082,47094,169001,85.17137538229689,121919,123.0,12,974,LARGE,126,,,
219,47786,47802,169032,85.17137538229689,121246,124.1,16,950,LARGE,128,,,
232,49631,49648,169068,85.17137538229689,119437,123.1,17,954,LARGE,126,,,
258,54694,56358,169142,85.17137538229689,114448,127.5,1664,881,LARGE,130,,,
314,65385,68179,169465,85.17137538229689,104080,125.1,2794,810,LARGE,129,,,
442,90480,94080,169899,85.17137538229689,79419,113.8,3600,637,LARGE,125,,,
250,53729,55822,170472,85.17137538229689,116743,123.4,2093,916,LARGE,128,,,
302,62541,65270,170541,85.17137538229689,108000,122.2,2729,845,LARGE,128,,,
315,65426,68200,170588,85.17137538229689,105162,120.9,2774,854,LARGE,124,,,
317,65524,68242,170590,85.17137538229689,105066,120.9,2718,851,LARGE,124,,,
327,66592,68557,170619,85.17137538229689,104027,120.8,1965,857,LARGE,122,,,
484,96682,100286,170902,85.17137538229689,74220,110.0,3604,649,LARGE,115,,,
282,58755,58786,171230,85.17137538229689,112475,121.5,31,942,LARGE,120,,,
472,95300,98721,171558,85.17137538229689,76258,108.0,3421,672,LARGE,114,,,
490,97901,101244,171613,85.17137538229689,73712,107.4,3343,672,LARGE,110,,,
403,82592,85896,171775,85.17137538229689,89183,113.2,3304,734,LARGE,122,,,
290,59896,59930,171888,85.17137538229689,111992,117.2,34,957,LARGE,118,,,
305,63459,66194,171900,85.17137538229689,108441,116.7,2735,901,LARGE,121,,,
467,94628,98025,172281,85.17137538229689,77653,105.5,3397,684,LARGE,114,,,
281,58443,58463,172961,85.17137538229689,114518,117.4,20,973,LARGE,118,,,
321,65931,68368,173065,85.17137538229689,107134,112.5,2437,960,LARGE,112,,,
330,67387,68767,173082,85.17137538229689,105695,114.5,1380,926,LARGE,115,,,
392,80326,83612,173170,85.17137538229689,92844,105.9,3286,824,LARGE,113,,,
444,90847,94332,173250,85.17137538229689,82403,101.9,3485,757,LARGE,109,,,
462,93926,97413,173440,85.17137538229689,79514,98.7,3487,762,LARGE,105,,,
464,94416,97762,173474,85.17137538229689,79058,98.7,3346,762,LARGE,104,,,
485,97051,100685,173542,85.17137538229689,76491,100.3,3634,745,LARGE,103,,,
495,98548,101506,173654,85.17137538229689,75106,100.0,2958,737,LARGE,102,,,
396,80820,84089,173673,85.17137538229689,92853,105.8,3269,808,LARGE,115,,,
415,84783,87959,173984,85.17137538229689,89201,103.8,3176,839,LARGE,107,,,
310,64950,67665,174041,85.17137538229689,109091,110.5,2715,964,LARGE,114,,,
343,70308,73282,174061,85.17137538229689,103753,107.7,2974,919,LARGE,113,,,
460,93752,97299,174259,85.17137538229689,80507,94.3,3547,820,LARGE,99,,,
407,82967,86343,174582,85.17137538229689,91615,101.3,3376,850,LARGE,108,,,
440,89998,93732,174693,85.17137538229689,84695,93.1,3734,836,LARGE,102,,,
445,90929,94394,174698,85.17137538229689,83769,92.9,3465,834,LARGE,101,,,
491,98040,101307,174853,85.17137538229689,76813,89.1,3267,879,LARGE,88,,,
398,81529,84809,174911,85.17137538229689,93382,97.0,3280,895,LARGE,105,,,
402,82328,85626,174986,85.17137538229689,92658,97.0,3298,912,LARGE,102,,,
410,83250,86653,175020,85.17137538229689,91770,94.7,3403,922,LARGE,100,,,
387,79632,80289,175067,85.17137538229689,95435,99.6,657,995,LARGE,96,,,
479,96138,99687,175135,85.17137538229689,78997,87.5,3549,895,LARGE,89,,,
492,98321,101391,175299,85.17137538229689,76978,83.0,3070,937,LARGE,83,,,
401,82165,85458,175303,85.17137538229689,93138,88.9,3293,993,LARGE,94,,,
454,92385,95925,175324,85.17137538229689,82939,80.8,3540,1000,LARGE,83,,,
